API Start (ns),API Dur (ns),Queue Start (ns),Queue Dur (ns),Kernel Start (ns),Kernel Dur (ns),Total Dur (ns),PID,TID,DevId,API Function,GridXYZ,BlockXYZ,Kernel Name
318371767,800895684,1119267451,3988,1119271439,102402786,903302458,1944,1944,0,cudaLaunchKernel,  32    1    1,   1    1    1,foo()
1119270074,14243,1119284317,102391252,1221675569,102402564,204808059,1944,1944,0,cudaLaunchKernel,  32    1    1,   1    1    1,foo()
1119284751,9190,1119293941,204785568,1324079509,102402530,307197288,1944,1944,0,cudaLaunchKernel,  32    1    1,   1    1    1,foo()
1119294194,32027,1119326221,307157002,1426483223,102402722,409591751,1944,1944,0,cudaLaunchKernel,  32    1    1,   1    1    1,foo()
1119326596,9081,1119335677,409551676,1528887353,102402500,511963257,1944,1944,0,cudaLaunchKernel,  32    1    1,   1    1    1,foo()
1119335956,9832,1119345788,511945345,1631291133,102402626,614357803,1944,1944,0,cudaLaunchKernel,  32    1    1,   1    1    1,foo()
1119346063,9970,1119356033,614338942,1733694975,102402690,716751602,1944,1944,0,cudaLaunchKernel,  32    1    1,   1    1    1,foo()
1119356279,9828,1119366107,716732903,1836099010,102402563,819145294,1944,1944,0,cudaLaunchKernel,  32    1    1,   1    1    1,foo()
1119366342,9941,1119376283,819126698,1938502981,102402498,921539137,1944,1944,0,cudaLaunchKernel,  32    1    1,   1    1    1,foo()
1119376526,9982,1119386508,921520411,2040906919,102402467,1023932860,1944,1944,0,cudaLaunchKernel,  32    1    1,   1    1    1,foo()
1119386756,9884,1119396640,1023914218,2143310858,102402435,1126326537,1944,1944,0,cudaLaunchKernel,  32    1    1,   1    1    1,foo()
1119396894,10013,1119406907,1126307890,2245714797,102402402,1228720305,1944,1944,0,cudaLaunchKernel,  32    1    1,   1    1    1,foo()
1119407296,10065,1119417361,1228701214,2348118575,102402531,1331113810,1944,1944,0,cudaLaunchKernel,  32    1    1,   1    1    1,foo()
1119417707,9833,1119427540,1331095102,2450522642,102402370,1433507305,1944,1944,0,cudaLaunchKernel,  32    1    1,   1    1    1,foo()
1119427778,9692,1119437470,1433489079,2552926549,102402370,1535901141,1944,1944,0,cudaLaunchKernel,  32    1    1,   1    1    1,foo()
1119437707,9893,1119447600,1535882695,2655330295,102402531,1638295119,1944,1944,0,cudaLaunchKernel,  32    1    1,   1    1    1,foo()
1119447835,9889,1119457724,1638276510,2757734234,102402498,1740688897,1944,1944,0,cudaLaunchKernel,  32    1    1,   1    1    1,foo()
1119457961,9890,1119467851,1740670321,2860138172,102402466,1843082677,1944,1944,0,cudaLaunchKernel,  32    1    1,   1    1    1,foo()
1119468103,9866,1119477969,1843064174,2962542143,102402403,1945476443,1944,1944,0,cudaLaunchKernel,  32    1    1,   1    1    1,foo()
1119478227,9899,1119488126,1945457924,3064946050,102402402,2047870225,1944,1944,0,cudaLaunchKernel,  32    1    1,   1    1    1,foo()
1119488361,9802,1119498163,2047851857,3167350020,102402338,2150263997,1944,1944,0,cudaLaunchKernel,  32    1    1,   1    1    1,foo()
1119498389,9909,1119508298,2150245500,3269753798,102402468,2252657877,1944,1944,0,cudaLaunchKernel,  32    1    1,   1    1    1,foo()
1119508526,9902,1119518428,2252639342,3372157770,102402402,2355051646,1944,1944,0,cudaLaunchKernel,  32    1    1,   1    1    1,foo()
1119518679,9827,1119528506,2355033042,3474561548,102402530,2457445399,1944,1944,0,cudaLaunchKernel,  32    1    1,   1    1    1,foo()
1119528749,10391,1119539140,2457426378,3576965518,102402467,2559839236,1944,1944,0,cudaLaunchKernel,  32    1    1,   1    1    1,foo()
1119539376,9835,1119549211,2559820374,3679369585,102402307,2662232516,1944,1944,0,cudaLaunchKernel,  32    1    1,   1    1    1,foo()
1119549452,9829,1119559281,2662214147,3781773428,102402370,2764626346,1944,1944,0,cudaLaunchKernel,  32    1    1,   1    1    1,foo()
1119559490,10021,1119569511,2764607759,3884177270,102402435,2867020215,1944,1944,0,cudaLaunchKernel,  32    1    1,   1    1    1,foo()
1119569890,9742,1119579632,2867001577,3986581209,102402402,2969413721,1944,1944,0,cudaLaunchKernel,  32    1    1,   1    1    1,foo()
1119579979,9789,1119589768,2969395411,4088985179,102402340,3071807540,1944,1944,0,cudaLaunchKernel,  32    1    1,   1    1    1,foo()
1119589993,9718,1119599711,3071789312,4191389023,102402402,3174201432,1944,1944,0,cudaLaunchKernel,  32    1    1,   1    1    1,foo()
1119599934,9891,1119609825,3174183008,4293792833,102402499,3276595398,1944,1944,0,cudaLaunchKernel,  32    1    1,   1    1    1,foo()
1119610088,9775,1119619863,3276577005,4396196868,102402371,3378989151,1944,1944,0,cudaLaunchKernel,  32    1    1,   1    1    1,foo()
1119620098,9916,1119630014,3378970761,4498600775,102402371,3481383048,1944,1944,0,cudaLaunchKernel,  32    1    1,   1    1    1,foo()
1119630258,9791,1119640049,3481364473,4601004522,102402530,3583776794,1944,1944,0,cudaLaunchKernel,  32    1    1,   1    1    1,foo()
1119640279,9945,1119650224,3583758301,4703408525,102402435,3686170681,1944,1944,0,cudaLaunchKernel,  32    1    1,   1    1    1,foo()
1119650435,9822,1119660257,3686152143,4805812400,102402467,3788564432,1944,1944,0,cudaLaunchKernel,  32    1    1,   1    1    1,foo()
1119660490,28214,1119688704,3788527699,4908216403,102402370,3890958283,1944,1944,0,cudaLaunchKernel,  32    1    1,   1    1    1,foo()
1119689045,8869,1119697914,3890922363,5010620277,102402404,3993333636,1944,1944,0,cudaLaunchKernel,  32    1    1,   1    1    1,foo()
1119698165,9890,1119708055,3993316130,5113024185,102402402,4095728422,1944,1944,0,cudaLaunchKernel,  32    1    1,   1    1    1,foo()
1119708321,9734,1119718055,4095709972,5215428027,102402467,4198122173,1944,1944,0,cudaLaunchKernel,  32    1    1,   1    1    1,foo()
1119718303,9836,1119728139,4198103891,5317832030,102402371,4300516098,1944,1944,0,cudaLaunchKernel,  32    1    1,   1    1    1,foo()
1119728400,9815,1119738215,4300497722,5420235937,102402371,4402909908,1944,1944,0,cudaLaunchKernel,  32    1    1,   1    1    1,foo()
1119738460,9947,1119748407,4402891373,5522639780,102402434,4505303754,1944,1944,0,cudaLaunchKernel,  32    1    1,   1    1    1,foo()
1119748661,9863,1119758524,4505285258,5625043782,102402340,4607697461,1944,1944,0,cudaLaunchKernel,  32    1    1,   1    1    1,foo()
1119758749,9652,1119768401,4607679129,5727447530,102402498,4710091279,1944,1944,0,cudaLaunchKernel,  32    1    1,   1    1    1,foo()
1119768615,9887,1119778502,4710072934,5829851436,102402500,4812485321,1944,1944,0,cudaLaunchKernel,  32    1    1,   1    1    1,foo()
1119778718,9872,1119788590,4812466913,5932255503,102402339,4914879124,1944,1944,0,cudaLaunchKernel,  32    1    1,   1    1    1,foo()
1119788836,9823,1119798659,4914860783,6034659442,102402307,5017272913,1944,1944,0,cudaLaunchKernel,  32    1    1,   1    1    1,foo()
1119798881,9893,1119808774,5017254479,6137063253,102402405,5119666777,1944,1944,0,cudaLaunchKernel,  32    1    1,   1    1    1,foo()
1119809001,9867,1119818868,5119648326,6239467194,102402371,5222060564,1944,1944,0,cudaLaunchKernel,  32    1    1,   1    1    1,foo()
1119819094,9870,1119828964,5222042105,6341871069,102402403,5324454378,1944,1944,0,cudaLaunchKernel,  32    1    1,   1    1    1,foo()
1119829187,9880,1119839067,5324435973,6444275040,102402340,5426848193,1944,1944,0,cudaLaunchKernel,  32    1    1,   1    1    1,foo()
1119839312,9829,1119849141,5426829775,6546678916,102402372,5529241976,1944,1944,0,cudaLaunchKernel,  32    1    1,   1    1    1,foo()
1119849364,9877,1119859241,5529223487,6649082728,102402467,5631635831,1944,1944,0,cudaLaunchKernel,  32    1    1,   1    1    1,foo()
1119859480,9853,1119869333,5631617238,6751486571,102402532,5734029623,1944,1944,0,cudaLaunchKernel,  32    1    1,   1    1    1,foo()
1119869546,9850,1119879396,5734011147,6853890543,102402468,5836423465,1944,1944,0,cudaLaunchKernel,  32    1    1,   1    1    1,foo()
1119879615,9858,1119889473,5836405074,6956294547,102402371,5938817303,1944,1944,0,cudaLaunchKernel,  32    1    1,   1    1    1,foo()
1119889685,9834,1119899519,5938798967,7058698486,102402340,6041211141,1944,1944,0,cudaLaunchKernel,  32    1    1,   1    1    1,foo()
1119899732,9897,1119909629,6041192637,7161102266,102402468,6143605002,1944,1944,0,cudaLaunchKernel,  32    1    1,   1    1    1,foo()
1119909866,9934,1119919800,6143586310,7263506110,102402531,6245998775,1944,1944,0,cudaLaunchKernel,  32    1    1,   1    1    1,foo()
1119920021,9759,1119929780,6245980429,7365910209,102402340,6348392528,1944,1944,0,cudaLaunchKernel,  32    1    1,   1    1    1,foo()
1119930037,9815,1119939852,6348374169,7468314021,102402435,6450786419,1944,1944,0,cudaLaunchKernel,  32    1    1,   1    1    1,foo()
1119940084,9791,1119949875,6450768053,7570717928,102402436,6553180280,1944,1944,0,cudaLaunchKernel,  32    1    1,   1    1    1,foo()
1119950100,9832,1119959932,6553162032,7673121964,102402308,6655574172,1944,1944,0,cudaLaunchKernel,  32    1    1,   1    1    1,foo()
1119960158,9860,1119970018,6655555662,7775525680,102402499,6757968021,1944,1944,0,cudaLaunchKernel,  32    1    1,   1    1    1,foo()
1119970284,9829,1119980113,6757949538,7877929651,102402437,6860361804,1944,1944,0,cudaLaunchKernel,  32    1    1,   1    1    1,foo()
1119980336,9866,1119990202,6860343358,7980333560,102402435,6962755659,1944,1944,0,cudaLaunchKernel,  32    1    1,   1    1    1,foo()
1119990433,9840,1120000273,6962737130,8082737403,102402499,7065149469,1944,1944,0,cudaLaunchKernel,  32    1    1,   1    1    1,foo()
1120000520,9885,1120010405,7065130905,8185141310,102402500,7167543290,1944,1944,0,cudaLaunchKernel,  32    1    1,   1    1    1,foo()
1120010635,9869,1120020504,7167524682,8287545186,102402532,7269937083,1944,1944,0,cudaLaunchKernel,  32    1    1,   1    1    1,foo()
1120020734,9861,1120030595,7269918499,8389949094,102402531,7372330891,1944,1944,0,cudaLaunchKernel,  32    1    1,   1    1    1,foo()
1120030822,9819,1120040641,7372312392,8492353033,102402500,7474724711,1944,1944,0,cudaLaunchKernel,  32    1    1,   1    1    1,foo()
1120040872,9892,1120050764,7474706369,8594757133,102402307,7577118568,1944,1944,0,cudaLaunchKernel,  32    1    1,   1    1    1,foo()
1120050996,9816,1120060812,7577100100,8697160912,102402436,7679512352,1944,1944,0,cudaLaunchKernel,  32    1    1,   1    1    1,foo()
1120061046,9886,1120070932,7679493984,8799564916,102402340,7781906210,1944,1944,0,cudaLaunchKernel,  32    1    1,   1    1    1,foo()
1120071183,9886,1120081069,7781887563,8901968632,102402531,7884299980,1944,1944,0,cudaLaunchKernel,  32    1    1,   1    1    1,foo()
1120081292,10000,1120091292,7884281279,9004372571,102402499,7986693778,1944,1944,0,cudaLaunchKernel,  32    1    1,   1    1    1,foo()
1120091638,9962,1120101600,7986674974,9106776574,102402405,8089087341,1944,1944,0,cudaLaunchKernel,  32    1    1,   1    1    1,foo()
1120101833,9671,1120111504,8089068883,9209180387,102402499,8191481053,1944,1944,0,cudaLaunchKernel,  32    1    1,   1    1    1,foo()
1120111733,9756,1120121489,8191462901,9311584390,102402403,8293875060,1944,1944,0,cudaLaunchKernel,  32    1    1,   1    1    1,foo()
1120121709,9799,1120131508,8293856693,9413988201,102402500,8396268992,1944,1944,0,cudaLaunchKernel,  32    1    1,   1    1    1,foo()
1120131731,9836,1120141567,8396250574,9516392141,102402468,8498662878,1944,1944,0,cudaLaunchKernel,  32    1    1,   1    1    1,foo()
1120141789,9876,1120151665,8498644320,9618795985,102402532,8601056728,1944,1944,0,cudaLaunchKernel,  32    1    1,   1    1    1,foo()
1120151888,9876,1120161764,8601038256,9721200020,102402404,8703450536,1944,1944,0,cudaLaunchKernel,  32    1    1,   1    1    1,foo()
1120161991,9905,1120171896,8703431968,9823603864,102402467,8805844340,1944,1944,0,cudaLaunchKernel,  32    1    1,   1    1    1,foo()
1120172132,9896,1120182028,8805825743,9926007771,102402469,8908238108,1944,1944,0,cudaLaunchKernel,  32    1    1,   1    1    1,foo()
1120182273,9865,1120192138,8908219606,10028411744,102402403,9010631874,1944,1944,0,cudaLaunchKernel,  32    1    1,   1    1    1,foo()
1120192365,9872,1120202237,9010613319,10130815556,102402502,9113025693,1944,1944,0,cudaLaunchKernel,  32    1    1,   1    1    1,foo()
1120202476,9828,1120212304,9113007194,10233219498,102402472,9215419494,1944,1944,0,cudaLaunchKernel,  32    1    1,   1    1    1,foo()
1120212542,9864,1120222406,9215401132,10335623538,102402342,9317813338,1944,1944,0,cudaLaunchKernel,  32    1    1,   1    1    1,foo()
1120222660,9815,1120232475,9317794781,10438027256,102402535,9420207131,1944,1944,0,cudaLaunchKernel,  32    1    1,   1    1    1,foo()
1120232703,9893,1120242596,9420188603,10540431199,102402503,9522600999,1944,1944,0,cudaLaunchKernel,  32    1    1,   1    1    1,foo()
1120242823,9986,1120252809,9522582333,10642835142,102402471,9624994790,1944,1944,0,cudaLaunchKernel,  32    1    1,   1    1    1,foo()
1120253153,9716,1120262869,9624976152,10745239021,102402502,9727388370,1944,1944,0,cudaLaunchKernel,  32    1    1,   1    1    1,foo()
1120263104,9873,1120272977,9727369986,10847642963,102402472,9829782331,1944,1944,0,cudaLaunchKernel,  32    1    1,   1    1    1,foo()
1120273210,9875,1120283085,9829763886,10950046971,102402374,9932176135,1944,1944,0,cudaLaunchKernel,  32    1    1,   1    1    1,foo()
1120283325,9741,1120293066,9932157815,11052450881,102402375,10034569931,1944,1944,0,cudaLaunchKernel,  32    1    1,   1    1    1,foo()
1120293300,9833,1120303133,10034551627,11154854760,102402407,10136963867,1944,1944,0,cudaLaunchKernel,  32    1    1,   1    1    1,foo()
1120303340,9824,1120313164,10136945379,11257258543,102402535,10239357738,1944,1944,0,cudaLaunchKernel,  32    1    1,   1    1    1,foo()
11359696332,127514,11359823846,4851,11359828697,102402183,102534548,1944,1944,0,cudaLaunchKernel,  32    1    1,   1    1    1,bar()
11359824480,10778,11359835258,102397158,11462232416,102402374,204810310,1944,1944,0,cudaLaunchKernel,  32    1    1,   1    1    1,bar()
11359835670,10446,11359846116,204790178,11564636294,102402408,307203032,1944,1944,0,cudaLaunchKernel,  32    1    1,   1    1    1,bar()
11359846386,9846,11359856232,307184006,11667040238,102402374,409596226,1944,1944,0,cudaLaunchKernel,  32    1    1,   1    1    1,bar()
11359856470,9557,11359866027,409578089,11769444116,102402407,511990053,1944,1944,0,cudaLaunchKernel,  32    1    1,   1    1    1,bar()
11359866273,10581,11359876854,511971269,11871848123,102402311,614384161,1944,1944,0,cudaLaunchKernel,  32    1    1,   1    1    1,bar()
11359877227,9590,11359886817,614365122,11974251939,102402406,716777118,1944,1944,0,cudaLaunchKernel,  32    1    1,   1    1    1,bar()
11359887167,9903,11359897070,716758651,12076655721,102402534,819171088,1944,1944,0,cudaLaunchKernel,  32    1    1,   1    1    1,bar()
11359897433,9665,11359907098,819152565,12179059663,102402503,921564733,1944,1944,0,cudaLaunchKernel,  32    1    1,   1    1    1,bar()
11359907566,9695,11359917261,921546345,12281463606,102402470,1023958510,1944,1944,0,cudaLaunchKernel,  32    1    1,   1    1    1,bar()
11359917526,9813,11359927339,1023940209,12383867548,102402438,1126352460,1944,1944,0,cudaLaunchKernel,  32    1    1,   1    1    1,bar()
11359927566,9822,11359937388,1126334166,12486271554,102402343,1228746331,1944,1944,0,cudaLaunchKernel,  32    1    1,   1    1    1,bar()
11359937617,9871,11359947488,1228727945,12588675433,102402374,1331140190,1944,1944,0,cudaLaunchKernel,  32    1    1,   1    1    1,bar()
11359947724,9844,11359957568,1331121807,12691079375,102402341,1433533992,1944,1944,0,cudaLaunchKernel,  32    1    1,   1    1    1,bar()
11359957912,9831,11359967743,1433515381,12793483124,102402503,1535927715,1944,1944,0,cudaLaunchKernel,  32    1    1,   1    1    1,bar()
11359967969,10943,11359978912,1535908123,12895887035,102402502,1638321568,1944,1944,0,cudaLaunchKernel,  32    1    1,   1    1    1,bar()
11359979254,9733,11359988987,1638301958,12998290945,102402503,1740714194,1944,1944,0,cudaLaunchKernel,  32    1    1,   1    1    1,bar()
11359989384,9438,11359998822,1740696065,13100694887,102402471,1843107974,1944,1944,0,cudaLaunchKernel,  32    1    1,   1    1    1,bar()
11359999214,9759,11360008973,1843089793,13203098766,102402502,1945502054,1944,1944,0,cudaLaunchKernel,  32    1    1,   1    1    1,bar()
11360009225,10016,11360019241,1945483627,13305502868,102402311,2047895954,1944,1944,0,cudaLaunchKernel,  32    1    1,   1    1    1,bar()
11360019496,9680,11360029176,2047877539,13407906715,102402374,2150289593,1944,1944,0,cudaLaunchKernel,  32    1    1,   1    1    1,bar()
11360029406,9932,11360039338,2150271319,13510310657,102402341,2252683592,1944,1944,0,cudaLaunchKernel,  32    1    1,   1    1    1,bar()
11360039720,9721,11360049441,2252665094,13612714535,102402374,2355077189,1944,1944,0,cudaLaunchKernel,  32    1    1,   1    1    1,bar()
11360049834,9657,11360059491,2355058794,13715118285,102402534,2457470985,1944,1944,0,cudaLaunchKernel,  32    1    1,   1    1    1,bar()
11360059851,9775,11360069626,2457452601,13817522227,102402502,2559864878,1944,1944,0,cudaLaunchKernel,  32    1    1,   1    1    1,bar()
11360070003,9775,11360079778,2559846519,13919926297,102402343,2662258637,1944,1944,0,cudaLaunchKernel,  32    1    1,   1    1    1,bar()
11360080112,10802,11360090914,2662239294,14022330208,102402342,2764652438,1944,1944,0,cudaLaunchKernel,  32    1    1,   1    1    1,bar()
11360091299,9315,11360100614,2764633376,14124733990,102402471,2867045162,1944,1944,0,cudaLaunchKernel,  32    1    1,   1    1    1,bar()
11360100853,9435,11360110288,2867027741,14227138029,102402344,2969439520,1944,1944,0,cudaLaunchKernel,  32    1    1,   1    1    1,bar()
11360110530,10179,11360120709,2969421232,14329541941,102402343,3071833754,1944,1944,0,cudaLaunchKernel,  32    1    1,   1    1    1,bar()
11360120938,10352,11360131290,3071814402,14431945692,102402502,3174227256,1944,1944,0,cudaLaunchKernel,  32    1    1,   1    1    1,bar()
11360131639,9543,11360141182,3174208453,14534349635,102402471,3276620467,1944,1944,0,cudaLaunchKernel,  32    1    1,   1    1    1,bar()
11360141528,9772,11360151300,3276602214,14636753514,102402503,3379014489,1944,1944,0,cudaLaunchKernel,  32    1    1,   1    1    1,bar()
11360151646,9607,11360161253,3378996236,14739157489,102402439,3481408282,1944,1944,0,cudaLaunchKernel,  32    1    1,   1    1    1,bar()
11360161479,9890,11360171369,3481390095,14841561464,102402376,3583802361,1944,1944,0,cudaLaunchKernel,  32    1    1,   1    1    1,bar()
11360171599,9817,11360181416,3583783864,14943965280,102402471,3686196152,1944,1944,0,cudaLaunchKernel,  32    1    1,   1    1    1,bar()
11360181640,10422,11360192062,3686177129,15046369191,102402472,3788590023,1944,1944,0,cudaLaunchKernel,  32    1    1,   1    1    1,bar()
11360192319,9550,11360201869,3788571234,15148773103,102402471,3890983255,1944,1944,0,cudaLaunchKernel,  32    1    1,   1    1    1,bar()
11360202109,9850,11360211959,3890965119,15251177078,102402407,3993377376,1944,1944,0,cudaLaunchKernel,  32    1    1,   1    1    1,bar()
11360212197,9839,11360222036,3993358857,15353580893,102402504,4095771200,1944,1944,0,cudaLaunchKernel,  32    1    1,   1    1    1,bar()
11360222274,9866,11360232140,4095752761,15455984901,102402407,4198165034,1944,1944,0,cudaLaunchKernel,  32    1    1,   1    1    1,bar()
11360232370,9818,11360242188,4198146560,15558388748,102402470,4300558848,1944,1944,0,cudaLaunchKernel,  32    1    1,   1    1    1,bar()
11360242413,10080,11360252493,4300540261,15660792754,102402376,4402952717,1944,1944,0,cudaLaunchKernel,  32    1    1,   1    1    1,bar()
11360252715,9780,11360262495,4402934139,15763196634,102402407,4505346326,1944,1944,0,cudaLaunchKernel,  32    1    1,   1    1    1,bar()
11360262720,9887,11360272607,4505327874,15865600481,102402471,4607740232,1944,1944,0,cudaLaunchKernel,  32    1    1,   1    1    1,bar()
11360272830,9882,11360282712,4607721680,15968004392,102402472,4710134034,1944,1944,0,cudaLaunchKernel,  32    1    1,   1    1    1,bar()
11360282937,9877,11360292814,4710115618,16070408432,102402343,4812527838,1944,1944,0,cudaLaunchKernel,  32    1    1,   1    1    1,bar()
11360293074,9967,11360303041,4812509334,16172812375,102402311,4914921612,1944,1944,0,cudaLaunchKernel,  32    1    1,   1    1    1,bar()
11360303310,10109,11360313419,4914902739,16275216158,102402439,5017315287,1944,1944,0,cudaLaunchKernel,  32    1    1,   1    1    1,bar()
11360313660,9794,11360323454,5017296712,16377620166,102402342,5119708848,1944,1944,0,cudaLaunchKernel,  32    1    1,   1    1    1,bar()
11360323676,9872,11360333548,5119690528,16480024076,102402343,5222102743,1944,1944,0,cudaLaunchKernel,  32    1    1,   1    1    1,bar()
11360333782,9847,11360343629,5222084262,16582427891,102402440,5324496549,1944,1944,0,cudaLaunchKernel,  32    1    1,   1    1    1,bar()
11360343850,9881,11360353731,5324478008,16684831739,102402503,5426890392,1944,1944,0,cudaLaunchKernel,  32    1    1,   1    1    1,bar()
11360353966,9884,11360363850,5426871960,16787235810,102402343,5529284187,1944,1944,0,cudaLaunchKernel,  32    1    1,   1    1    1,bar()
11360364076,9854,11360373930,5529265758,16889639688,102402376,5631677988,1944,1944,0,cudaLaunchKernel,  32    1    1,   1    1    1,bar()
11360374161,9831,11360383992,5631659448,16992043440,102402535,5734071814,1944,1944,0,cudaLaunchKernel,  32    1    1,   1    1    1,bar()
11360384222,9813,11360394035,5734053476,17094447511,102402376,5836465665,1944,1944,0,cudaLaunchKernel,  32    1    1,   1    1    1,bar()
11360394269,9866,11360404135,5836447352,17196851487,102402310,5938859528,1944,1944,0,cudaLaunchKernel,  32    1    1,   1    1    1,bar()
11360404363,10533,11360414896,5938840438,17299255334,102402374,6041253345,1944,1944,0,cudaLaunchKernel,  32    1    1,   1    1    1,bar()
11360415139,9645,11360424784,6041234460,17401659244,102402376,6143646481,1944,1944,0,cudaLaunchKernel,  32    1    1,   1    1    1,bar()
11360425017,9709,11360434726,6143628494,17504063220,102402311,6246040514,1944,1944,0,cudaLaunchKernel,  32    1    1,   1    1    1,bar()
11360434955,9868,11360444823,6246022148,17606466971,102402471,6348434487,1944,1944,0,cudaLaunchKernel,  32    1    1,   1    1    1,bar()
11360445053,9855,11360454908,6348415974,17708870882,102402471,6450828300,1944,1944,0,cudaLaunchKernel,  32    1    1,   1    1    1,bar()
11360455125,9865,11360464990,6450809899,17811274889,102402375,6553222139,1944,1944,0,cudaLaunchKernel,  32    1    1,   1    1    1,bar()
11360465219,9853,11360475072,6553203728,17913678800,102402375,6655615956,1944,1944,0,cudaLaunchKernel,  32    1    1,   1    1    1,bar()
11360475296,9863,11360485159,6655597648,18016082807,102402280,6758009791,1944,1944,0,cudaLaunchKernel,  32    1    1,   1    1    1,bar()
11360485382,9878,11360495260,6757991395,18118486655,102402344,6860403617,1944,1944,0,cudaLaunchKernel,  32    1    1,   1    1    1,bar()
11360495482,9864,11360505346,6860385254,18220890600,102402313,6962797431,1944,1944,0,cudaLaunchKernel,  32    1    1,   1    1    1,bar()
11360505573,10564,11360516137,6962778312,18323294449,102402378,7065191254,1944,1944,0,cudaLaunchKernel,  32    1    1,   1    1    1,bar()
11360516372,9429,11360525801,7065172467,18425698268,102402473,7167584369,1944,1944,0,cudaLaunchKernel,  32    1    1,   1    1    1,bar()
11360526032,9863,11360535895,7167566318,18528102213,102402442,7269978623,1944,1944,0,cudaLaunchKernel,  32    1    1,   1    1    1,bar()
11360536130,9833,11360545963,7269960260,18630506223,102402346,7372372439,1944,1944,0,cudaLaunchKernel,  32    1    1,   1    1    1,bar()
11360546201,9831,11360556032,7372353945,18732909977,102402506,7474766282,1944,1944,0,cudaLaunchKernel,  32    1    1,   1    1    1,bar()
11360556268,9835,11360566103,7474747980,18835314083,102402314,7577160129,1944,1944,0,cudaLaunchKernel,  32    1    1,   1    1    1,bar()
11360566338,9859,11360576197,7577141736,18937717933,102402378,7679553973,1944,1944,0,cudaLaunchKernel,  32    1    1,   1    1    1,bar()
11360576421,9931,11360586352,7679535399,19040121751,102402473,7781947803,1944,1944,0,cudaLaunchKernel,  32    1    1,   1    1    1,bar()
11360586578,9777,11360596355,7781929309,19142525664,102402475,7884341561,1944,1944,0,cudaLaunchKernel,  32    1    1,   1    1    1,bar()
11360596582,9788,11360606370,7884323273,19244929643,102402409,7986735470,1944,1944,0,cudaLaunchKernel,  32    1    1,   1    1    1,bar()
11360606600,9868,11360616468,7986717024,19347333492,102402474,8089129366,1944,1944,0,cudaLaunchKernel,  32    1    1,   1    1    1,bar()
11360616694,11041,11360627735,8089109703,19449737438,102402442,8191523186,1944,1944,0,cudaLaunchKernel,  32    1    1,   1    1    1,bar()
11360627972,9284,11360637256,8191504096,19552141352,102402442,8293915822,1944,1944,0,cudaLaunchKernel,  32    1    1,   1    1    1,bar()
11360637481,9488,11360646969,8293898265,19654545234,102402473,8396310226,1944,1944,0,cudaLaunchKernel,  32    1    1,   1    1    1,bar()
11360647187,9915,11360657102,8396292205,19756949307,102402315,8498704435,1944,1944,0,cudaLaunchKernel,  32    1    1,   1    1    1,bar()
11360657317,9866,11360667183,8498686007,19859353190,102402345,8601098218,1944,1944,0,cudaLaunchKernel,  32    1    1,   1    1    1,bar()
11360667406,9852,11360677258,8601079877,19961757135,102402314,8703492043,1944,1944,0,cudaLaunchKernel,  32    1    1,   1    1    1,bar()
11360677471,9895,11360687366,8703473651,20064161017,102402346,8805885892,1944,1944,0,cudaLaunchKernel,  32    1    1,   1    1    1,bar()
11360687583,9887,11360697470,8805867397,20166564867,102402410,8908279694,1944,1944,0,cudaLaunchKernel,  32    1    1,   1    1    1,bar()
11360697681,9895,11360707576,8908261205,20268968781,102402409,9010673509,1944,1944,0,cudaLaunchKernel,  32    1    1,   1    1    1,bar()
11360707797,9944,11360717741,9010655081,20371372822,102402282,9113067307,1944,1944,0,cudaLaunchKernel,  32    1    1,   1    1    1,bar()
11360717960,10164,11360728124,9113048516,20473776640,102402378,9215461058,1944,1944,0,cudaLaunchKernel,  32    1    1,   1    1    1,bar()
11360728347,10282,11360738629,9215441797,20576180426,102402506,9317854585,1944,1944,0,cudaLaunchKernel,  32    1    1,   1    1    1,bar()
11360738879,9783,11360748662,9317835678,20678584340,102402505,9420247966,1944,1944,0,cudaLaunchKernel,  32    1    1,   1    1    1,bar()
11360748896,9988,11360758884,9420229497,20780988381,102402378,9522641863,1944,1944,0,cudaLaunchKernel,  32    1    1,   1    1    1,bar()
11360759111,10003,11360769114,9522623181,20883392295,102402378,9625035562,1944,1944,0,cudaLaunchKernel,  32    1    1,   1    1    1,bar()
11360769354,10226,11360779580,9625016501,20985796081,102402506,9727429233,1944,1944,0,cudaLaunchKernel,  32    1    1,   1    1    1,bar()
11360779827,10139,11360789966,9727410189,21088200155,102402345,9829822673,1944,1944,0,cudaLaunchKernel,  32    1    1,   1    1    1,bar()
11360790182,10307,11360800489,9829803451,21190603940,102402474,9932216232,1944,1944,0,cudaLaunchKernel,  32    1    1,   1    1    1,bar()
11360800705,10151,11360810856,9932196998,21293007854,102402474,10034609623,1944,1944,0,cudaLaunchKernel,  32    1    1,   1    1    1,bar()
11360811071,10236,11360821307,10034590621,21395411928,102402313,10137003170,1944,1944,0,cudaLaunchKernel,  32    1    1,   1    1    1,bar()
11360821529,10128,11360831657,10136983992,21497815649,102402506,10239396626,1944,1944,0,cudaLaunchKernel,  32    1    1,   1    1    1,bar()
21600239113,20178,21600259291,6257,21600265548,102402601,102429036,1944,1944,0,cudaLaunchKernel,  32    1    1,   1    1    1,foo()
21600260784,7676,21600268460,102401097,21702669557,102402507,204811280,1944,1944,0,cudaLaunchKernel,  32    1    1,   1    1    1,foo()
21600268726,10982,21600279708,204793892,21805073600,102402377,307207251,1944,1944,0,cudaLaunchKernel,  32    1    1,   1    1    1,foo()
21600279950,9987,21600289937,307187544,21907477481,102402409,409599940,1944,1944,0,cudaLaunchKernel,  32    1    1,   1    1    1,foo()
21600290184,9582,21600299766,409581629,22009881395,102402410,511993621,1944,1944,0,cudaLaunchKernel,  32    1    1,   1    1    1,foo()
21600300004,9728,21600309732,511975609,22112285341,102402378,614387715,1944,1944,0,cudaLaunchKernel,  32    1    1,   1    1    1,foo()
21600309973,10011,21600319984,614369239,22214689223,102402411,716781661,1944,1944,0,cudaLaunchKernel,  32    1    1,   1    1    1,foo()
21600320258,9850,21600330108,716763030,22317093138,102402412,819175292,1944,1944,0,cudaLaunchKernel,  32    1    1,   1    1    1,foo()
21600330364,10251,21600340615,819156407,22419497022,102402442,921569100,1944,1944,0,cudaLaunchKernel,  32    1    1,   1    1    1,foo()
21600341023,9944,21600350967,921549969,22521900936,102402443,1023962356,1944,1944,0,cudaLaunchKernel,  32    1    1,   1    1    1,foo()
21600351210,9886,21600361096,1023943819,22624304915,102402380,1126356085,1944,1944,0,cudaLaunchKernel,  32    1    1,   1    1    1,foo()
21600361363,10886,21600372249,1126336550,22726708799,102402411,1228749847,1944,1944,0,cudaLaunchKernel,  32    1    1,   1    1    1,foo()
21600372506,9237,21600381743,1228730843,22829112586,102402540,1331142620,1944,1944,0,cudaLaunchKernel,  32    1    1,   1    1    1,foo()
21600381974,9699,21600391673,1331124957,22931516630,102402410,1433537066,1944,1944,0,cudaLaunchKernel,  32    1    1,   1    1    1,foo()
21600391909,9896,21600401805,1433518740,23033920545,102402410,1535931046,1944,1944,0,cudaLaunchKernel,  32    1    1,   1    1    1,foo()
21600402040,9890,21600411930,1535912529,23136324459,102402412,1638324831,1944,1944,0,cudaLaunchKernel,  32    1    1,   1    1    1,foo()
21600412171,9878,21600422049,1638306422,23238728471,102402315,1740718615,1944,1944,0,cudaLaunchKernel,  32    1    1,   1    1    1,foo()
21600422285,9882,21600432167,1740700091,23341132258,102402443,1843112416,1944,1944,0,cudaLaunchKernel,  32    1    1,   1    1    1,foo()
21600432398,10002,21600442400,1843093805,23443536205,102402412,1945506219,1944,1944,0,cudaLaunchKernel,  32    1    1,   1    1    1,foo()
21600442649,9772,21600452421,1945487572,23545939993,102402538,2047899882,1944,1944,0,cudaLaunchKernel,  32    1    1,   1    1    1,foo()
21600452660,9874,21600462534,2047881437,23648343971,102402475,2150293786,1944,1944,0,cudaLaunchKernel,  32    1    1,   1    1    1,foo()
21600462767,9900,21600472667,2150275379,23750748046,102402316,2252687595,1944,1944,0,cudaLaunchKernel,  32    1    1,   1    1    1,foo()
21600472904,10896,21600483800,2252668066,23853151866,102402411,2355081373,1944,1944,0,cudaLaunchKernel,  32    1    1,   1    1    1,foo()
21600484034,9476,21600493510,2355062271,23955555781,102402411,2457474158,1944,1944,0,cudaLaunchKernel,  32    1    1,   1    1    1,foo()
21600493745,9837,21600503582,2457456018,24057959600,102402507,2559868362,1944,1944,0,cudaLaunchKernel,  32    1    1,   1    1    1,foo()
21600503957,9815,21600513772,2559849872,24160363644,102402379,2662262066,1944,1944,0,cudaLaunchKernel,  32    1    1,   1    1    1,foo()
21600514027,10055,21600524082,2662243413,24262767495,102402444,2764655912,1944,1944,0,cudaLaunchKernel,  32    1    1,   1    1    1,foo()
21600524340,9816,21600534156,2764637191,24365171347,102402509,2867049516,1944,1944,0,cudaLaunchKernel,  32    1    1,   1    1    1,foo()
21600534385,9763,21600544148,2867031116,24467575264,102402508,2969443387,1944,1944,0,cudaLaunchKernel,  32    1    1,   1    1    1,foo()
21600544380,9912,21600554292,2969425016,24569979308,102402380,3071837308,1944,1944,0,cudaLaunchKernel,  32    1    1,   1    1    1,foo()
21600554529,9909,21600564438,3071818753,24672383191,102402413,3174231075,1944,1944,0,cudaLaunchKernel,  32    1    1,   1    1    1,foo()
21600564661,9863,21600574524,3174212488,24774787012,102402508,3276624859,1944,1944,0,cudaLaunchKernel,  32    1    1,   1    1    1,foo()
21600574745,11053,21600585798,3276605226,24877191024,102402413,3379018692,1944,1944,0,cudaLaunchKernel,  32    1    1,   1    1    1,foo()
21600586040,9336,21600595376,3378999501,24979594877,102402476,3481411313,1944,1944,0,cudaLaunchKernel,  32    1    1,   1    1    1,foo()
21600595608,9591,21600605199,3481393690,25081998889,102402379,3583805660,1944,1944,0,cudaLaunchKernel,  32    1    1,   1    1    1,foo()
21600605433,9909,21600615342,3583787462,25184402804,102402381,3686199752,1944,1944,0,cudaLaunchKernel,  32    1    1,   1    1    1,foo()
21600615570,9886,21600625456,3686181105,25286806561,102402540,3788593531,1944,1944,0,cudaLaunchKernel,  32    1    1,   1    1    1,foo()
21600625710,9847,21600635557,3788575080,25389210637,102402380,3890987307,1944,1944,0,cudaLaunchKernel,  32    1    1,   1    1    1,foo()
21600635780,9956,21600645736,3890968753,25491614489,102402444,3993381153,1944,1944,0,cudaLaunchKernel,  32    1    1,   1    1    1,foo()
21600645979,9807,21600655786,3993362620,25594018406,102402443,4095774870,1944,1944,0,cudaLaunchKernel,  32    1    1,   1    1    1,foo()
21600656039,9899,21600665938,4095756447,25696422385,102402380,4198168726,1944,1944,0,cudaLaunchKernel,  32    1    1,   1    1    1,foo()
21600666169,9995,21600676164,4198150137,25798826301,102402381,4300562513,1944,1944,0,cudaLaunchKernel,  32    1    1,   1    1    1,foo()
21600676403,10199,21600686602,4300543584,25901230186,102402412,4402956195,1944,1944,0,cudaLaunchKernel,  32    1    1,   1    1    1,foo()
21600686842,9996,21600696838,4402937232,26003634070,102402443,4505349671,1944,1944,0,cudaLaunchKernel,  32    1    1,   1    1    1,foo()
21600697087,10370,21600707457,4505330560,26106038017,102402413,4607743343,1944,1944,0,cudaLaunchKernel,  32    1    1,   1    1    1,foo()
21600707703,9874,21600717577,4607724453,26208442030,102402313,4710136640,1944,1944,0,cudaLaunchKernel,  32    1    1,   1    1    1,foo()
21600717839,9901,21600727740,4710118139,26310845879,102402377,4812530417,1944,1944,0,cudaLaunchKernel,  32    1    1,   1    1    1,foo()
21600727976,9843,21600737819,4812511941,26413249760,102402411,4914924195,1944,1944,0,cudaLaunchKernel,  32    1    1,   1    1    1,foo()
21600738054,9967,21600748021,4914905558,26515653579,102402505,5017318030,1944,1944,0,cudaLaunchKernel,  32    1    1,   1    1    1,foo()
21600748267,9800,21600758067,5017299425,26618057492,102402507,5119711732,1944,1944,0,cudaLaunchKernel,  32    1    1,   1    1    1,foo()
21600758321,9876,21600768197,5119693338,26720461535,102402377,5222105591,1944,1944,0,cudaLaunchKernel,  32    1    1,   1    1    1,foo()
21600768423,9950,21600778373,5222086915,26822865288,102402538,5324499403,1944,1944,0,cudaLaunchKernel,  32    1    1,   1    1    1,foo()
21600778629,9898,21600788527,5324480867,26925269394,102402346,5426893111,1944,1944,0,cudaLaunchKernel,  32    1    1,   1    1    1,foo()
21600788769,9852,21600798621,5426874623,27027673244,102402409,5529286884,1944,1944,0,cudaLaunchKernel,  32    1    1,   1    1    1,foo()
21600798873,10027,21600808900,5529268289,27130077189,102402378,5631680694,1944,1944,0,cudaLaunchKernel,  32    1    1,   1    1    1,foo()
21600809137,10323,21600819460,5631661483,27232480943,102402538,5734074344,1944,1944,0,cudaLaunchKernel,  32    1    1,   1    1    1,foo()
21600819697,10180,21600829877,5734055012,27334884889,102402506,5836467698,1944,1944,0,cudaLaunchKernel,  32    1    1,   1    1    1,foo()
21600830132,9846,21600839978,5836448889,27437288867,102402441,5938861176,1944,1944,0,cudaLaunchKernel,  32    1    1,   1    1    1,foo()
21600840209,9999,21600850208,5938842668,27539692876,102402346,6041255013,1944,1944,0,cudaLaunchKernel,  32    1    1,   1    1    1,foo()
21600850467,9755,21600860222,6041236376,27642096598,102402538,6143648669,1944,1944,0,cudaLaunchKernel,  32    1    1,   1    1    1,foo()
21600860460,9931,21600870391,6143630121,27744500512,102402537,6246042589,1944,1944,0,cudaLaunchKernel,  32    1    1,   1    1    1,foo()
21600870639,9839,21600880478,6246024043,27846904521,102402443,6348436325,1944,1944,0,cudaLaunchKernel,  32    1    1,   1    1    1,foo()
21600880718,9932,21600890650,6348417690,27949308340,102402537,6450830159,1944,1944,0,cudaLaunchKernel,  32    1    1,   1    1    1,foo()
21600890898,9862,21600900760,6450811621,28051712381,102402410,6553223893,1944,1944,0,cudaLaunchKernel,  32    1    1,   1    1    1,foo()
21600901007,9916,21600910923,6553205436,28154116359,102402350,6655617702,1944,1944,0,cudaLaunchKernel,  32    1    1,   1    1    1,foo()
21600911179,9812,21600920991,6655599126,28256520117,102402512,6758011450,1944,1944,0,cudaLaunchKernel,  32    1    1,   1    1    1,foo()
21600921243,9831,21600931074,6757993027,28358924101,102402449,6860405307,1944,1944,0,cudaLaunchKernel,  32    1    1,   1    1    1,foo()
21600931320,9936,21600941256,6860386797,28461328053,102402417,6962799150,1944,1944,0,cudaLaunchKernel,  32    1    1,   1    1    1,foo()
21600941522,9837,21600951359,6962780615,28563731974,102402416,7065192868,1944,1944,0,cudaLaunchKernel,  32    1    1,   1    1    1,foo()
21600951592,9901,21600961493,7065174497,28666135990,102402321,7167586719,1944,1944,0,cudaLaunchKernel,  32    1    1,   1    1    1,foo()
21600961730,9902,21600971632,7167568183,28768539815,102402416,7269980501,1944,1944,0,cudaLaunchKernel,  32    1    1,   1    1    1,foo()
21600971860,9932,21600981792,7269961847,28870943639,102402512,7372374291,1944,1944,0,cudaLaunchKernel,  32    1    1,   1    1    1,foo()
21600982028,9870,21600991898,7372355821,28973347719,102402353,7474768044,1944,1944,0,cudaLaunchKernel,  32    1    1,   1    1    1,foo()
21600992130,9895,21601002025,7474749455,29075751480,102402512,7577161862,1944,1944,0,cudaLaunchKernel,  32    1    1,   1    1    1,foo()
21601002255,10007,21601012262,7577143234,29178155496,102402416,7679555657,1944,1944,0,cudaLaunchKernel,  32    1    1,   1    1    1,foo()
21601012493,9844,21601022337,7679537079,29280559416,102402417,7781949340,1944,1944,0,cudaLaunchKernel,  32    1    1,   1    1    1,foo()
21601022598,9804,21601032402,7781930935,29382963337,102402416,7884343155,1944,1944,0,cudaLaunchKernel,  32    1    1,   1    1    1,foo()
21601032623,9897,21601042520,7884324673,29485367193,102402480,7986737050,1944,1944,0,cudaLaunchKernel,  32    1    1,   1    1    1,foo()
21601042770,9874,21601052644,7986718629,29587771273,102402321,8089130824,1944,1944,0,cudaLaunchKernel,  32    1    1,   1    1    1,foo()
21601052877,9889,21601062766,8089112332,29690175098,102402416,8191524637,1944,1944,0,cudaLaunchKernel,  32    1    1,   1    1    1,foo()
21601063000,9896,21601072896,8191506026,29792578922,102402512,8293918434,1944,1944,0,cudaLaunchKernel,  32    1    1,   1    1    1,foo()
21601073146,9838,21601082984,8293899922,29894982906,102402449,8396312209,1944,1944,0,cudaLaunchKernel,  32    1    1,   1    1    1,foo()
21601083205,9992,21601093197,8396293630,29997386827,102402448,8498706070,1944,1944,0,cudaLaunchKernel,  32    1    1,   1    1    1,foo()
21601093445,9891,21601103336,8498687411,30099790747,102402448,8601099750,1944,1944,0,cudaLaunchKernel,  32    1    1,   1    1    1,foo()
21601103568,9830,21601113398,8601081205,30202194603,102402510,8703493545,1944,1944,0,cudaLaunchKernel,  32    1    1,   1    1    1,foo()
21601113628,9882,21601123510,8703475171,30304598681,102402350,8805887403,1944,1944,0,cudaLaunchKernel,  32    1    1,   1    1    1,foo()
21601123746,9949,21601133695,8805868904,30407002599,102402350,8908281203,1944,1944,0,cudaLaunchKernel,  32    1    1,   1    1    1,foo()
21601133954,9800,21601143754,8908262731,30509406485,102402382,9010674913,1944,1944,0,cudaLaunchKernel,  32    1    1,   1    1    1,foo()
21601143986,9904,21601153890,9010656513,30611810403,102402381,9113068798,1944,1944,0,cudaLaunchKernel,  32    1    1,   1    1    1,foo()
21601154120,9862,21601163982,9113050338,30714214320,102402383,9215462583,1944,1944,0,cudaLaunchKernel,  32    1    1,   1    1    1,foo()
21601164236,9864,21601174100,9215443979,30816618079,102402541,9317856384,1944,1944,0,cudaLaunchKernel,  32    1    1,   1    1    1,foo()
21601174335,10020,21601184355,9317837673,30919022028,102402509,9420250202,1944,1944,0,cudaLaunchKernel,  32    1    1,   1    1    1,foo()
21601184592,9777,21601194369,9420231736,31021426105,102402351,9522643864,1944,1944,0,cudaLaunchKernel,  32    1    1,   1    1    1,foo()
21601194599,9854,21601204453,9522625507,31123829960,102402413,9625037774,1944,1944,0,cudaLaunchKernel,  32    1    1,   1    1    1,foo()
21601204688,9930,21601214618,9625019259,31226233877,102402414,9727431603,1944,1944,0,cudaLaunchKernel,  32    1    1,   1    1    1,foo()
21601214851,9807,21601224658,9727413137,31328637795,102402414,9829825358,1944,1944,0,cudaLaunchKernel,  32    1    1,   1    1    1,foo()
21601224894,9980,21601234874,9829806743,31431041617,102402510,9932219233,1944,1944,0,cudaLaunchKernel,  32    1    1,   1    1    1,foo()
21601235119,9774,21601244893,9932200674,31533445567,102402477,10034612925,1944,1944,0,cudaLaunchKernel,  32    1    1,   1    1    1,foo()
21601245142,9869,21601255011,10034594409,31635849420,102402542,10137006820,1944,1944,0,cudaLaunchKernel,  32    1    1,   1    1    1,foo()
21601255252,9877,21601265129,10136988273,31738253402,102402478,10239400628,1944,1944,0,cudaLaunchKernel,  32    1    1,   1    1    1,foo()
31840674070,21576,31840695646,5258,31840700904,102402927,102429761,1944,1944,0,cudaLaunchKernel,  32    1    1,   1    1    1,bar()
31840696045,8319,31840704364,102401003,31943105367,102402381,204811703,1944,1944,0,cudaLaunchKernel,  32    1    1,   1    1    1,bar()
31840704794,10543,31840715337,204794011,32045509348,102402318,307206872,1944,1944,0,cudaLaunchKernel,  32    1    1,   1    1    1,bar()
31840715571,9937,31840725508,307187662,32147913170,102402415,409600014,1944,1944,0,cudaLaunchKernel,  32    1    1,   1    1    1,bar()
31840725751,9769,31840735520,409581505,32250317025,102402481,511993755,1944,1944,0,cudaLaunchKernel,  32    1    1,   1    1    1,bar()
31840735774,9741,31840745515,511975559,32352721074,102402354,614387654,1944,1944,0,cudaLaunchKernel,  32    1    1,   1    1    1,bar()
31840745763,9848,31840755611,614369288,32455124899,102402450,716781586,1944,1944,0,cudaLaunchKernel,  32    1    1,   1    1    1,bar()
31840755838,11164,31840767002,716761915,32557528917,102402353,819175432,1944,1944,0,cudaLaunchKernel,  32    1    1,   1    1    1,bar()
31840767311,10191,31840777502,819155176,32659932678,102402514,921567881,1944,1944,0,cudaLaunchKernel,  32    1    1,   1    1    1,bar()
31840777762,9926,31840787688,921548944,32762336632,102402481,1023961351,1944,1944,0,cudaLaunchKernel,  32    1    1,   1    1    1,bar()
31840787956,9883,31840797839,1023942874,32864740713,102402321,1126355078,1944,1944,0,cudaLaunchKernel,  32    1    1,   1    1    1,bar()
31840798084,9825,31840807909,1126336661,32967144570,102402386,1228748872,1944,1944,0,cudaLaunchKernel,  32    1    1,   1    1    1,bar()
31840808154,9952,31840818106,1228730450,33069548556,102402321,1331142723,1944,1944,0,cudaLaunchKernel,  32    1    1,   1    1    1,bar()
31840818354,9839,31840828193,1331124188,33171952381,102402417,1433536444,1944,1944,0,cudaLaunchKernel,  32    1    1,   1    1    1,bar()
31840828443,9889,31840838332,1433517970,33274356302,102402418,1535930277,1944,1944,0,cudaLaunchKernel,  32    1    1,   1    1    1,bar()
31840838575,9815,31840848390,1535911738,33376760128,102402513,1638324066,1944,1944,0,cudaLaunchKernel,  32    1    1,   1    1    1,bar()
31840848658,9890,31840858548,1638305533,33479164081,102402481,1740717904,1944,1944,0,cudaLaunchKernel,  32    1    1,   1    1    1,bar()
31840858818,9903,31840868721,1740699281,33581568002,102402482,1843111666,1944,1944,0,cudaLaunchKernel,  32    1    1,   1    1    1,bar()
31840868973,10911,31840879884,1843092104,33683971988,102402416,1945505431,1944,1944,0,cudaLaunchKernel,  32    1    1,   1    1    1,bar()
31840880165,9446,31840889611,1945486330,33786375941,102402384,2047898160,1944,1944,0,cudaLaunchKernel,  32    1    1,   1    1    1,bar()
31840889888,9830,31840899718,2047880047,33888779765,102402482,2150292359,1944,1944,0,cudaLaunchKernel,  32    1    1,   1    1    1,bar()
31840899967,9855,31840909822,2150273865,33991183687,102402481,2252686201,1944,1944,0,cudaLaunchKernel,  32    1    1,   1    1    1,bar()
31840910106,9806,31840919912,2252667632,34093587544,102402545,2355079983,1944,1944,0,cudaLaunchKernel,  32    1    1,   1    1    1,bar()
31840920175,10036,31840930211,2355061254,34195991465,102402546,2457473836,1944,1944,0,cudaLaunchKernel,  32    1    1,   1    1    1,bar()
31840930450,9942,31840940392,2457455155,34298395547,102402385,2559867482,1944,1944,0,cudaLaunchKernel,  32    1    1,   1    1    1,bar()
31840940628,9923,31840950551,2559848917,34400799468,102402386,2662261226,1944,1944,0,cudaLaunchKernel,  32    1    1,   1    1    1,bar()
31840950913,9884,31840960797,2662242593,34503203390,102402385,2764654862,1944,1944,0,cudaLaunchKernel,  32    1    1,   1    1    1,bar()
31840961041,9870,31840970911,2764636336,34605607247,102402449,2867048655,1944,1944,0,cudaLaunchKernel,  32    1    1,   1    1    1,bar()
31840971159,10852,31840982011,2867029254,34708011265,102402354,2969442460,1944,1944,0,cudaLaunchKernel,  32    1    1,   1    1    1,bar()
31840982282,9388,31840991670,2969423517,34810415187,102402353,3071835258,1944,1944,0,cudaLaunchKernel,  32    1    1,   1    1    1,bar()
31840991916,9862,31841001778,3071817330,34912819108,102402353,3174229545,1944,1944,0,cudaLaunchKernel,  32    1    1,   1    1    1,bar()
31841001998,9951,31841011949,3174210920,35015222869,102402514,3276623385,1944,1944,0,cudaLaunchKernel,  32    1    1,   1    1    1,bar()
31841012215,9850,31841022065,3276604918,35117626983,102402321,3379017089,1944,1944,0,cudaLaunchKernel,  32    1    1,   1    1    1,bar()
31841022301,9851,31841032152,3378998592,35220030744,102402481,3481410924,1944,1944,0,cudaLaunchKernel,  32    1    1,   1    1    1,bar()
31841032392,9877,31841042269,3481392492,35322434761,102402386,3583804755,1944,1944,0,cudaLaunchKernel,  32    1    1,   1    1    1,bar()
31841042507,9909,31841052416,3583786139,35424838555,102402513,3686198561,1944,1944,0,cudaLaunchKernel,  32    1    1,   1    1    1,bar()
31841052673,9864,31841062537,3686179971,35527242508,102402481,3788592316,1944,1944,0,cudaLaunchKernel,  32    1    1,   1    1    1,bar()
31841062772,9937,31841072709,3788573720,35629646429,102402482,3890986139,1944,1944,0,cudaLaunchKernel,  32    1    1,   1    1    1,bar()
31841072970,9869,31841082839,3890967608,35732050447,102402385,3993379862,1944,1944,0,cudaLaunchKernel,  32    1    1,   1    1    1,bar()
31841083091,10902,31841093993,3993360375,35834454368,102402385,4095773662,1944,1944,0,cudaLaunchKernel,  32    1    1,   1    1    1,bar()
31841094257,9627,31841103884,4095754469,35936858353,102402322,4198166418,1944,1944,0,cudaLaunchKernel,  32    1    1,   1    1    1,bar()
31841104139,9792,31841113931,4198148376,36039262307,102402289,4300560457,1944,1944,0,cudaLaunchKernel,  32    1    1,   1    1    1,bar()
31841114279,9820,31841124099,4300542065,36141666164,102402354,4402954239,1944,1944,0,cudaLaunchKernel,  32    1    1,   1    1    1,bar()
31841124352,9798,31841134150,4402935903,36244070053,102402386,4505348087,1944,1944,0,cudaLaunchKernel,  32    1    1,   1    1    1,bar()
31841134387,10130,31841144517,4505329458,36346473975,102402385,4607741973,1944,1944,0,cudaLaunchKernel,  32    1    1,   1    1    1,bar()
31841144770,9958,31841154728,4607723232,36448877960,102402321,4710135511,1944,1944,0,cudaLaunchKernel,  32    1    1,   1    1    1,bar()
31841154963,9920,31841164883,4710116870,36551281753,102402449,4812529239,1944,1944,0,cudaLaunchKernel,  32    1    1,   1    1    1,bar()
31841165140,9818,31841174958,4812510652,36653685610,102402513,4914922983,1944,1944,0,cudaLaunchKernel,  32    1    1,   1    1    1,bar()
31841175192,9843,31841185035,4914904528,36756089563,102402481,5017316852,1944,1944,0,cudaLaunchKernel,  32    1    1,   1    1    1,bar()
31841185286,9879,31841195165,5017298319,36858493484,102402481,5119710679,1944,1944,0,cudaLaunchKernel,  32    1    1,   1    1    1,bar()
31841195432,10886,31841206318,5119691247,36960897565,102402320,5222104453,1944,1944,0,cudaLaunchKernel,  32    1    1,   1    1    1,bar()
31841206582,9547,31841216129,5222085292,37063301421,102402386,5324497225,1944,1944,0,cudaLaunchKernel,  32    1    1,   1    1    1,bar()
31841216374,9885,31841226259,5324479116,37165705375,102402353,5426891354,1944,1944,0,cudaLaunchKernel,  32    1    1,   1    1    1,bar()
31841226526,9837,31841236363,5426872997,37268109360,102402288,5529285122,1944,1944,0,cudaLaunchKernel,  32    1    1,   1    1    1,bar()
31841236609,9953,31841246562,5529266590,37370513152,102402418,5631678961,1944,1944,0,cudaLaunchKernel,  32    1    1,   1    1    1,bar()
31841246791,9883,31841256674,5631660432,37472917106,102402385,5734072700,1944,1944,0,cudaLaunchKernel,  32    1    1,   1    1    1,bar()
31841256897,10053,31841266950,5734053981,37575320931,102402480,5836466514,1944,1944,0,cudaLaunchKernel,  32    1    1,   1    1    1,bar()
31841267215,10081,31841277296,5836447683,37677724979,102402354,5938860118,1944,1944,0,cudaLaunchKernel,  32    1    1,   1    1    1,bar()
31841277652,9773,31841287425,5938841444,37780128869,102402384,6041253601,1944,1944,0,cudaLaunchKernel,  32    1    1,   1    1    1,bar()
31841287797,9945,31841297742,6041235079,37882532821,102402353,6143647377,1944,1944,0,cudaLaunchKernel,  32    1    1,   1    1    1,bar()
31841297988,11033,31841309021,6143627593,37984936614,102402482,6246041108,1944,1944,0,cudaLaunchKernel,  32    1    1,   1    1    1,bar()
31841309271,9178,31841318449,6246022087,38087340536,102402480,6348433745,1944,1944,0,cudaLaunchKernel,  32    1    1,   1    1    1,bar()
31841318726,9770,31841328496,6348415896,38189744392,102402547,6450828213,1944,1944,0,cudaLaunchKernel,  32    1    1,   1    1    1,bar()
31841328735,9894,31841338629,6450809846,38292148475,102402387,6553222127,1944,1944,0,cudaLaunchKernel,  32    1    1,   1    1    1,bar()
31841338882,9923,31841348805,6553203497,38394552302,102402482,6655615902,1944,1944,0,cudaLaunchKernel,  32    1    1,   1    1    1,bar()
31841349032,9849,31841358881,6655597375,38496956256,102402452,6758009676,1944,1944,0,cudaLaunchKernel,  32    1    1,   1    1    1,bar()
31841359142,9900,31841369042,6757991074,38599360116,102402514,6860403488,1944,1944,0,cudaLaunchKernel,  32    1    1,   1    1    1,bar()
31841369280,9914,31841379194,6860384844,38701764038,102402515,6962797273,1944,1944,0,cudaLaunchKernel,  32    1    1,   1    1    1,bar()
31841379437,9933,31841389370,6962778751,38804168121,102402355,7065191039,1944,1944,0,cudaLaunchKernel,  32    1    1,   1    1    1,bar()
31841389592,9911,31841399503,7065172541,38906572044,102402355,7167584807,1944,1944,0,cudaLaunchKernel,  32    1    1,   1    1    1,bar()
31841399746,9958,31841409704,7167566135,39008975839,102402482,7269978575,1944,1944,0,cudaLaunchKernel,  32    1    1,   1    1    1,bar()
31841409958,10922,31841420880,7269958945,39111379825,102402420,7372372287,1944,1944,0,cudaLaunchKernel,  32    1    1,   1    1    1,bar()
31841421136,9426,31841430562,7372353283,39213783845,102402322,7474765031,1944,1944,0,cudaLaunchKernel,  32    1    1,   1    1    1,bar()
31841430811,9923,31841440734,7474747001,39316187735,102402355,7577159279,1944,1944,0,cudaLaunchKernel,  32    1    1,   1    1    1,bar()
31841440980,9741,31841450721,7577140841,39418591562,102402451,7679553033,1944,1944,0,cudaLaunchKernel,  32    1    1,   1    1    1,bar()
31841450968,9864,31841460832,7679534621,39520995453,102402483,7781946968,1944,1944,0,cudaLaunchKernel,  32    1    1,   1    1    1,bar()
31841461085,9905,31841470990,7781928482,39623399472,102402386,7884340773,1944,1944,0,cudaLaunchKernel,  32    1    1,   1    1    1,bar()
31841471228,9834,31841481062,7884322428,39725803490,102402292,7986734554,1944,1944,0,cudaLaunchKernel,  32    1    1,   1    1    1,bar()
31841481298,9926,31841491224,7986716062,39828207286,102402418,8089128406,1944,1944,0,cudaLaunchKernel,  32    1    1,   1    1    1,bar()
31841491469,9853,31841501322,8089109982,39930611304,102402324,8191522159,1944,1944,0,cudaLaunchKernel,  32    1    1,   1    1    1,bar()
31841501553,9921,31841511474,8191503721,40033015195,102402355,8293915997,1944,1944,0,cudaLaunchKernel,  32    1    1,   1    1    1,bar()
31841511729,9869,31841521598,8293897424,40135419022,102402451,8396309744,1944,1944,0,cudaLaunchKernel,  32    1    1,   1    1    1,bar()
31841521830,9969,31841531799,8396291210,40237823009,102402389,8498703568,1944,1944,0,cudaLaunchKernel,  32    1    1,   1    1    1,bar()
31841532108,9796,31841541904,8498684934,40340226838,102402484,8601097214,1944,1944,0,cudaLaunchKernel,  32    1    1,   1    1    1,bar()
31841542147,9883,31841552030,8601078860,40442630890,102402356,8703491099,1944,1944,0,cudaLaunchKernel,  32    1    1,   1    1    1,bar()
31841552275,9835,31841562110,8703472768,40545034878,102402293,8805884896,1944,1944,0,cudaLaunchKernel,  32    1    1,   1    1    1,bar()
31841562355,9903,31841572258,8805866449,40647438707,102402388,8908278740,1944,1944,0,cudaLaunchKernel,  32    1    1,   1    1    1,bar()
31841572519,9820,31841582339,8908260260,40749842599,102402420,9010672500,1944,1944,0,cudaLaunchKernel,  32    1    1,   1    1    1,bar()
31841582594,9857,31841592451,9010654040,40852246491,102402453,9113066350,1944,1944,0,cudaLaunchKernel,  32    1    1,   1    1    1,bar()
31841592716,24379,31841617095,9113033418,40954650513,102402356,9215460153,1944,1944,0,cudaLaunchKernel,  32    1    1,   1    1    1,bar()
31841617456,8929,31841626385,9215428084,41057054469,102402324,9317839337,1944,1944,0,cudaLaunchKernel,  32    1    1,   1    1    1,bar()
31841626627,9823,31841636450,9317821879,41159458329,102402389,9420234091,1944,1944,0,cudaLaunchKernel,  32    1    1,   1    1    1,bar()
31841636698,9925,31841646623,9420215631,41261862254,102402388,9522627944,1944,1944,0,cudaLaunchKernel,  32    1    1,   1    1    1,bar()
31841646887,9721,31841656608,9522609666,41364266274,102402292,9625021679,1944,1944,0,cudaLaunchKernel,  32    1    1,   1    1    1,bar()
31841656853,9867,31841666720,9625003350,41466670070,102402421,9727415638,1944,1944,0,cudaLaunchKernel,  32    1    1,   1    1    1,bar()
31841666970,9829,31841676799,9727397260,41569074059,102402356,9829809445,1944,1944,0,cudaLaunchKernel,  32    1    1,   1    1    1,bar()
31841677033,9874,31841686907,9829790916,41671477823,102402516,9932203306,1944,1944,0,cudaLaunchKernel,  32    1    1,   1    1    1,bar()
31841687146,9831,31841696977,9932184802,41773881779,102402486,10034597119,1944,1944,0,cudaLaunchKernel,  32    1    1,   1    1    1,bar()
31841697203,9940,31841707143,10034578530,41876285673,102402516,10136990986,1944,1944,0,cudaLaunchKernel,  32    1    1,   1    1    1,bar()
31841707376,9812,31841717188,10136972409,41978689597,102402517,10239384738,1944,1944,0,cudaLaunchKernel,  32    1    1,   1    1    1,bar()
42081109393,23565,42081132958,4692,42081137650,102402420,102430677,1944,1944,0,cudaLaunchKernel,  32    1    1,   1    1    1,foo()
42081133292,8396,42081141688,102399790,42183541478,102402517,204810703,1944,1944,0,cudaLaunchKernel,  32    1    1,   1    1    1,foo()
42081142113,9707,42081151820,204793679,42285945499,102402420,307205806,1944,1944,0,cudaLaunchKernel,  32    1    1,   1    1    1,foo()
42081153230,12107,42081165337,307184086,42388349423,102402419,409598612,1944,1944,0,cudaLaunchKernel,  32    1    1,   1    1    1,foo()
42081165622,10915,42081176537,409576681,42490753218,102402549,511990145,1944,1944,0,cudaLaunchKernel,  32    1    1,   1    1    1,foo()
42081176775,10118,42081186893,511970410,42593157303,102402387,614382915,1944,1944,0,cudaLaunchKernel,  32    1    1,   1    1    1,foo()
42081187124,10323,42081197447,614363619,42695561066,102402547,716776489,1944,1944,0,cudaLaunchKernel,  32    1    1,   1    1    1,foo()
42081197690,9647,42081207337,716757684,42797965021,102402517,819169848,1944,1944,0,cudaLaunchKernel,  32    1    1,   1    1    1,foo()
42081207731,10193,42081217924,819151022,42900368946,102402515,921563730,1944,1944,0,cudaLaunchKernel,  32    1    1,   1    1    1,foo()
42081218318,9869,42081228187,921544810,43002772997,102402388,1023957067,1944,1944,0,cudaLaunchKernel,  32    1    1,   1    1    1,foo()
42081228616,10134,42081238750,1023938075,43105176825,102402484,1126350693,1944,1944,0,cudaLaunchKernel,  32    1    1,   1    1    1,foo()
42081239087,10054,42081249141,1126331672,43207580813,102402419,1228744145,1944,1944,0,cudaLaunchKernel,  32    1    1,   1    1    1,foo()
42081249478,9760,42081259238,1228725562,43309984800,102402356,1331137678,1944,1944,0,cudaLaunchKernel,  32    1    1,   1    1    1,foo()
42081259473,9901,42081269374,1331119190,43412388564,102402516,1433531607,1944,1944,0,cudaLaunchKernel,  32    1    1,   1    1    1,foo()
42081269601,10942,42081280543,1433512137,43514792680,102402324,1535925403,1944,1944,0,cudaLaunchKernel,  32    1    1,   1    1    1,foo()
42081280795,9935,42081290730,1535905778,43617196508,102402419,1638318132,1944,1944,0,cudaLaunchKernel,  32    1    1,   1    1    1,foo()
42081291063,9699,42081300762,1638299573,43719600335,102402516,1740711788,1944,1944,0,cudaLaunchKernel,  32    1    1,   1    1    1,foo()
42081301105,9798,42081310903,1740693452,43822004355,102402420,1843105670,1944,1944,0,cudaLaunchKernel,  32    1    1,   1    1    1,foo()
42081311239,9804,42081321043,1843087268,43924408311,102402388,1945499460,1944,1944,0,cudaLaunchKernel,  32    1    1,   1    1    1,foo()
42081321387,10067,42081331454,1945480653,44026812107,102402516,2047893236,1944,1944,0,cudaLaunchKernel,  32    1    1,   1    1    1,foo()
42081331816,9511,42081341327,2047874704,44129216031,102402515,2150286730,1944,1944,0,cudaLaunchKernel,  32    1    1,   1    1    1,foo()
42081341700,9611,42081351311,2150268675,44231619986,102402486,2252680772,1944,1944,0,cudaLaunchKernel,  32    1    1,   1    1    1,foo()
42081351550,9924,42081361474,2252662502,44334023976,102402422,2355074848,1944,1944,0,cudaLaunchKernel,  32    1    1,   1    1    1,foo()
42081361697,10313,42081372010,2355055828,44436427838,102402485,2457468626,1944,1944,0,cudaLaunchKernel,  32    1    1,   1    1    1,foo()
42081372354,9607,42081381961,2457449898,44538831859,102402391,2559861896,1944,1944,0,cudaLaunchKernel,  32    1    1,   1    1    1,foo()
42081382628,10804,42081393432,2559842322,44641235754,102402422,2662255548,1944,1944,0,cudaLaunchKernel,  32    1    1,   1    1    1,foo()
42081393774,9731,42081403505,2662236047,44743639552,102402549,2764648327,1944,1944,0,cudaLaunchKernel,  32    1    1,   1    1    1,foo()
42081403912,9820,42081413732,2764629745,44846043477,102402551,2867042116,1944,1944,0,cudaLaunchKernel,  32    1    1,   1    1    1,foo()
42081414087,9757,42081423844,2867023560,44948447404,102402550,2969435867,1944,1944,0,cudaLaunchKernel,  32    1    1,   1    1    1,foo()
42081424174,9890,42081434064,2969417330,45050851394,102402485,3071829705,1944,1944,0,cudaLaunchKernel,  32    1    1,   1    1    1,foo()
42081434293,9760,42081444053,3071811330,45153255383,102402423,3174223513,1944,1944,0,cudaLaunchKernel,  32    1    1,   1    1    1,foo()
42081444269,9949,42081454218,3174205060,45255659278,102402454,3276617463,1944,1944,0,cudaLaunchKernel,  32    1    1,   1    1    1,foo()
42081454557,9767,42081464324,3276598816,45358063140,102402517,3379011100,1944,1944,0,cudaLaunchKernel,  32    1    1,   1    1    1,foo()
42081464699,9792,42081474491,3378992703,45460467194,102402390,3481404885,1944,1944,0,cudaLaunchKernel,  32    1    1,   1    1    1,foo()
42081474718,10303,42081485021,3481386035,45562871056,102402454,3583798792,1944,1944,0,cudaLaunchKernel,  32    1    1,   1    1    1,foo()
42081485354,10271,42081495625,3583779293,45665274918,102402519,3686192083,1944,1944,0,cudaLaunchKernel,  32    1    1,   1    1    1,foo()
42081496441,9606,42081506047,3686172861,45767678908,102402454,3788584921,1944,1944,0,cudaLaunchKernel,  32    1    1,   1    1    1,foo()
42081506430,10092,42081516522,3788566440,45870082962,102402326,3890978858,1944,1944,0,cudaLaunchKernel,  32    1    1,   1    1    1,foo()
42081516747,9747,42081526494,3890960298,45972486792,102402423,3993372468,1944,1944,0,cudaLaunchKernel,  32    1    1,   1    1    1,foo()
42081526721,9975,42081536696,3993353927,46074890623,102402517,4095766419,1944,1944,0,cudaLaunchKernel,  32    1    1,   1    1    1,foo()
42081537058,10184,42081547242,4095747338,46177294580,102402486,4198160008,1944,1944,0,cudaLaunchKernel,  32    1    1,   1    1    1,foo()
42081547563,9893,42081557456,4198141114,46279698570,102402423,4300553430,1944,1944,0,cudaLaunchKernel,  32    1    1,   1    1    1,foo()
42081557785,10087,42081567872,4300534497,46382102369,102402551,4402947135,1944,1944,0,cudaLaunchKernel,  32    1    1,   1    1    1,foo()
42081568206,10048,42081578254,4402928202,46484506456,102402390,4505340640,1944,1944,0,cudaLaunchKernel,  32    1    1,   1    1    1,foo()
42081578585,10111,42081588696,4505321654,46586910350,102402423,4607734188,1944,1944,0,cudaLaunchKernel,  32    1    1,   1    1    1,foo()
42081589030,9757,42081598787,4607715522,46689314309,102402391,4710127670,1944,1944,0,cudaLaunchKernel,  32    1    1,   1    1    1,foo()
42081599007,11179,42081610186,4710107922,46791718108,102402518,4812521619,1944,1944,0,cudaLaunchKernel,  32    1    1,   1    1    1,foo()
42081610452,9992,42081620444,4812501718,46894122162,102402391,4914914101,1944,1944,0,cudaLaunchKernel,  32    1    1,   1    1    1,foo()
42081620783,9599,42081630382,4914895772,46996526154,102402326,5017307697,1944,1944,0,cudaLaunchKernel,  32    1    1,   1    1    1,foo()
42081630706,9640,42081640346,5017289542,47098929888,102402518,5119701700,1944,1944,0,cudaLaunchKernel,  32    1    1,   1    1    1,foo()
42081640697,9666,42081650363,5119683451,47201333814,102402519,5222095636,1944,1944,0,cudaLaunchKernel,  32    1    1,   1    1    1,foo()
42081650707,25802,42081676509,5222061361,47303737870,102402390,5324489553,1944,1944,0,cudaLaunchKernel,  32    1    1,   1    1    1,foo()
42081678100,7812,42081685912,5324455948,47406141860,102402326,5426866086,1944,1944,0,cudaLaunchKernel,  32    1    1,   1    1    1,foo()
42081686467,10751,42081697218,5426848376,47508545594,102402520,5529261647,1944,1944,0,cudaLaunchKernel,  32    1    1,   1    1    1,foo()
42081697473,9956,42081707429,5529242221,47610949650,102402390,5631654567,1944,1944,0,cudaLaunchKernel,  32    1    1,   1    1    1,foo()
42081707667,9999,42081717666,5631635942,47713353608,102402359,5734048300,1944,1944,0,cudaLaunchKernel,  32    1    1,   1    1    1,foo()
42081718019,9144,42081727163,5734030340,47815757503,102402391,5836441875,1944,1944,0,cudaLaunchKernel,  32    1    1,   1    1    1,foo()
42081727549,10876,42081738425,5836423069,47918161494,102402326,5938836271,1944,1944,0,cudaLaunchKernel,  32    1    1,   1    1    1,foo()
42081738825,9670,42081748495,5938816701,48020565196,102402551,6041228922,1944,1944,0,cudaLaunchKernel,  32    1    1,   1    1    1,foo()
42081748838,9866,42081758704,6041210611,48122969315,102402359,6143622836,1944,1944,0,cudaLaunchKernel,  32    1    1,   1    1    1,foo()
42081759031,9751,42081768782,6143604268,48225373050,102402548,6246016567,1944,1944,0,cudaLaunchKernel,  32    1    1,   1    1    1,foo()
42081769138,9661,42081778799,6245998335,48327777134,102402388,6348410384,1944,1944,0,cudaLaunchKernel,  32    1    1,   1    1    1,foo()
42081779032,9912,42081788944,6348392083,48430181027,102402418,6450804413,1944,1944,0,cudaLaunchKernel,  32    1    1,   1    1    1,foo()
42081789163,9891,42081799054,6450785768,48532584822,102402547,6553198206,1944,1944,0,cudaLaunchKernel,  32    1    1,   1    1    1,foo()
42081799478,10125,42081809603,6553179366,48634988969,102402324,6655591815,1944,1944,0,cudaLaunchKernel,  32    1    1,   1    1    1,foo()
42081810022,9959,42081819981,6655572720,48737392701,102402515,6757985194,1944,1944,0,cudaLaunchKernel,  32    1    1,   1    1    1,foo()
42081820329,10001,42081830330,6757966326,48839796656,102402483,6860378810,1944,1944,0,cudaLaunchKernel,  32    1    1,   1    1    1,foo()
42081830706,9801,42081840507,6860360008,48942200515,102402548,6962772357,1944,1944,0,cudaLaunchKernel,  32    1    1,   1    1    1,foo()
42081841141,10714,42081851855,6962752712,49044604567,102402419,7065165845,1944,1944,0,cudaLaunchKernel,  32    1    1,   1    1    1,foo()
42081852186,10021,42081862207,7065146283,49147008490,102402419,7167558723,1944,1944,0,cudaLaunchKernel,  32    1    1,   1    1    1,foo()
42081862428,9754,42081872182,7167540103,49249412285,102402548,7269952405,1944,1944,0,cudaLaunchKernel,  32    1    1,   1    1    1,foo()
42081872417,9653,42081882070,7269934267,49351816337,102402419,7372346339,1944,1944,0,cudaLaunchKernel,  32    1    1,   1    1    1,foo()
42081882406,9950,42081892356,7372327936,49454220292,102402388,7474740274,1944,1944,0,cudaLaunchKernel,  32    1    1,   1    1    1,foo()
42081892625,10112,42081902737,7474721478,49556624215,102402388,7577133978,1944,1944,0,cudaLaunchKernel,  32    1    1,   1    1    1,foo()
42081903075,9442,42081912517,7577115590,49659028107,102402419,7679527451,1944,1944,0,cudaLaunchKernel,  32    1    1,   1    1    1,foo()
42081912846,9664,42081922510,7679509424,49761431934,102402516,7781921604,1944,1944,0,cudaLaunchKernel,  32    1    1,   1    1    1,foo()
42081923042,9587,42081932629,7781903325,49863835954,102402419,7884315331,1944,1944,0,cudaLaunchKernel,  32    1    1,   1    1    1,foo()
42081932963,9774,42081942737,7884297140,49966239877,102402419,7986709333,1944,1944,0,cudaLaunchKernel,  32    1    1,   1    1    1,foo()
42081942956,9951,42081952907,7986690893,50068643800,102402420,8089103264,1944,1944,0,cudaLaunchKernel,  32    1    1,   1    1    1,foo()
42081953154,9846,42081963000,8089084660,50171047660,102402483,8191496989,1944,1944,0,cudaLaunchKernel,  32    1    1,   1    1    1,foo()
42081963337,9722,42081973059,8191478620,50273451679,102402394,8293890736,1944,1944,0,cudaLaunchKernel,  32    1    1,   1    1    1,foo()
42081973392,11140,42081984532,8293871109,50375855641,102402364,8396284613,1944,1944,0,cudaLaunchKernel,  32    1    1,   1    1    1,foo()
42081984786,10009,42081994795,8396264618,50478259413,102402523,8498677150,1944,1944,0,cudaLaunchKernel,  32    1    1,   1    1    1,foo()
42081995022,9605,42082004627,8498658653,50580663280,102402588,8601070846,1944,1944,0,cudaLaunchKernel,  32    1    1,   1    1    1,foo()
42082004871,9908,42082014779,8601052497,50683067276,102402524,8703464929,1944,1944,0,cudaLaunchKernel,  32    1    1,   1    1    1,foo()
42082015003,9886,42082024889,8703446447,50785471336,102402395,8805858728,1944,1944,0,cudaLaunchKernel,  32    1    1,   1    1    1,foo()
42082025124,9879,42082035003,8805840104,50887875107,102402555,8908252538,1944,1944,0,cudaLaunchKernel,  32    1    1,   1    1    1,foo()
42082035233,9898,42082045131,8908234003,50990279134,102402460,9010646361,1944,1944,0,cudaLaunchKernel,  32    1    1,   1    1    1,foo()
42082045346,10023,42082055369,9010627825,51092683194,102402332,9113040180,1944,1944,0,cudaLaunchKernel,  32    1    1,   1    1    1,foo()
42082055624,9759,42082065383,9113021647,51195087030,102402427,9215433833,1944,1944,0,cudaLaunchKernel,  32    1    1,   1    1    1,foo()
42082065603,9904,42082075507,9215415326,51297490833,102402556,9317827786,1944,1944,0,cudaLaunchKernel,  32    1    1,   1    1    1,foo()
42082075724,9819,42082085543,9317809350,51399894893,102402427,9420221596,1944,1944,0,cudaLaunchKernel,  32    1    1,   1    1    1,foo()
42082085763,9941,42082095704,9420203152,51502298856,102402396,9522615489,1944,1944,0,cudaLaunchKernel,  32    1    1,   1    1    1,foo()
42082095927,9877,42082105804,9522596920,51604702724,102402460,9625009257,1944,1944,0,cudaLaunchKernel,  32    1    1,   1    1    1,foo()
42082106022,9929,42082115951,9624990641,51707106592,102402523,9727403093,1944,1944,0,cudaLaunchKernel,  32    1    1,   1    1    1,foo()
42082116166,9876,42082126042,9727384545,51809510587,102402460,9829796881,1944,1944,0,cudaLaunchKernel,  32    1    1,   1    1    1,foo()
42082126267,9886,42082136153,9829778334,51911914487,102402491,9932190711,1944,1944,0,cudaLaunchKernel,  32    1    1,   1    1    1,foo()
42082136366,9912,42082146278,9932172108,52014318386,102402523,10034584543,1944,1944,0,cudaLaunchKernel,  32    1    1,   1    1    1,foo()
42082146502,9985,42082156487,10034565926,52116722413,102402429,10136978340,1944,1944,0,cudaLaunchKernel,  32    1    1,   1    1    1,foo()
42082156707,9903,42082166610,10136959704,52219126314,102402458,10239372065,1944,1944,0,cudaLaunchKernel,  32    1    1,   1    1    1,foo()
