API Start (ns),API Dur (ns),Queue Start (ns),Queue Dur (ns),Kernel Start (ns),Kernel Dur (ns),Total Dur (ns),PID,TID,DevId,API Function,GridXYZ,BlockXYZ,Kernel Name
288988663,1126706474,1415695137,992,1415696129,102403286,1229110752,4157,4157,0,cudaLaunchKernel,  32    1    1,   1    1    1,foo()
1415697855,18130,1415715985,102384614,1518100599,102403479,204806223,4157,4157,0,cudaLaunchKernel,  32    1    1,   1    1    1,foo()
1415716709,11318,1415728027,204777363,1620505390,102403351,307192032,4157,4157,0,cudaLaunchKernel,  32    1    1,   1    1    1,foo()
1415728472,10712,1415739184,307170709,1722909893,102403510,409584931,4157,4157,0,cudaLaunchKernel,  32    1    1,   1    1    1,foo()
1415739594,11897,1415751491,409563224,1825314715,102403351,511978472,4157,4157,0,cudaLaunchKernel,  32    1    1,   1    1    1,foo()
1415751878,9999,1415761877,511957341,1927719218,102403510,614370850,4157,4157,0,cudaLaunchKernel,  32    1    1,   1    1    1,foo()
1415762279,12116,1415774395,614349549,2030123944,102403446,716765111,4157,4157,0,cudaLaunchKernel,  32    1    1,   1    1    1,foo()
1415774781,10307,1415785088,716743678,2132528766,102403285,819157270,4157,4157,0,cudaLaunchKernel,  32    1    1,   1    1    1,foo()
1415785472,10570,1415796042,819137545,2234933587,102403125,921551240,4157,4157,0,cudaLaunchKernel,  32    1    1,   1    1    1,foo()
1415796468,10041,1415806509,921531804,2337338313,102403061,1023944906,4157,4157,0,cudaLaunchKernel,  32    1    1,   1    1    1,foo()
1415806944,9974,1415816918,1023925991,2439742909,102403126,1126339091,4157,4157,0,cudaLaunchKernel,  32    1    1,   1    1    1,foo()
1415817321,12370,1415829691,1126317688,2542147379,102403317,1228733375,4157,4157,0,cudaLaunchKernel,  32    1    1,   1    1    1,foo()
1415830119,10093,1415840212,1228712052,2644552264,102403093,1331125238,4157,4157,0,cudaLaunchKernel,  32    1    1,   1    1    1,foo()
1415840641,9853,1415850494,1331106463,2746956957,102403062,1433519378,4157,4157,0,cudaLaunchKernel,  32    1    1,   1    1    1,foo()
1415850898,9845,1415860743,1433500747,2849361490,102403190,1535913782,4157,4157,0,cudaLaunchKernel,  32    1    1,   1    1    1,foo()
1415861123,9870,1415870993,1535895255,2951766248,102403093,1638308218,4157,4157,0,cudaLaunchKernel,  32    1    1,   1    1    1,foo()
1415871367,10093,1415881460,1638289257,3054170717,102403285,1740702635,4157,4157,0,cudaLaunchKernel,  32    1    1,   1    1    1,foo()
1415881826,9990,1415891816,1740683754,3156575570,102403093,1843096837,4157,4157,0,cudaLaunchKernel,  32    1    1,   1    1    1,foo()
1415892190,9967,1415902157,1843077883,3258980040,102403285,1945491135,4157,4157,0,cudaLaunchKernel,  32    1    1,   1    1    1,foo()
1415902546,9863,1415912409,1945472420,3361384829,102403157,2047885440,4157,4157,0,cudaLaunchKernel,  32    1    1,   1    1    1,foo()
1415912768,9928,1415922696,2047866858,3463789554,102403093,2150279879,4157,4157,0,cudaLaunchKernel,  32    1    1,   1    1    1,foo()
1415923064,9908,1415932972,2150261083,3566194055,102403254,2252674245,4157,4157,0,cudaLaunchKernel,  32    1    1,   1    1    1,foo()
1415933333,16503,1415949836,2252648977,3668598813,102403157,2355068637,4157,4157,0,cudaLaunchKernel,  32    1    1,   1    1    1,foo()
1415950247,9844,1415960091,2355043351,3771003442,102403189,2457456384,4157,4157,0,cudaLaunchKernel,  32    1    1,   1    1    1,foo()
1415960501,9823,1415970324,2457437811,3873408135,102403157,2559850791,4157,4157,0,cudaLaunchKernel,  32    1    1,   1    1    1,foo()
1415970739,9832,1415980571,2559832257,3975812828,102403126,2662245215,4157,4157,0,cudaLaunchKernel,  32    1    1,   1    1    1,foo()
1415980942,9888,1415990830,2662226596,4078217426,102403191,2764639675,4157,4157,0,cudaLaunchKernel,  32    1    1,   1    1    1,foo()
1415991201,10091,1416001292,2764620797,4180622089,102403192,2867034080,4157,4157,0,cudaLaunchKernel,  32    1    1,   1    1    1,foo()
1416001658,9824,1416011482,2867015174,4283026656,102403288,2969428286,4157,4157,0,cudaLaunchKernel,  32    1    1,   1    1    1,foo()
1416011849,10022,1416021871,2969409609,4385431480,102403127,3071822758,4157,4157,0,cudaLaunchKernel,  32    1    1,   1    1    1,foo()
1416022275,9920,1416032195,3071803916,4487836111,102403159,3174216995,4157,4157,0,cudaLaunchKernel,  32    1    1,   1    1    1,foo()
1416032586,9910,1416042496,3174198214,4590240710,102403223,3276611347,4157,4157,0,cudaLaunchKernel,  32    1    1,   1    1    1,foo()
1416042871,10105,1416052976,3276592493,4692645469,102403128,3379005726,4157,4157,0,cudaLaunchKernel,  32    1    1,   1    1    1,foo()
1416053350,11746,1416065096,3378985101,4795050197,102403063,3481399910,4157,4157,0,cudaLaunchKernel,  32    1    1,   1    1    1,foo()
1416065495,9905,1416075400,3481379204,4897454604,102403319,3583792428,4157,4157,0,cudaLaunchKernel,  32    1    1,   1    1    1,foo()
1416075788,9903,1416085691,3583773608,4999859299,102403287,3686186798,4157,4157,0,cudaLaunchKernel,  32    1    1,   1    1    1,foo()
1416086079,9803,1416095882,3686168112,5102263994,102403256,3788581171,4157,4157,0,cudaLaunchKernel,  32    1    1,   1    1    1,foo()
1416096281,9956,1416106237,3788562485,5204668722,102403191,3890975632,4157,4157,0,cudaLaunchKernel,  32    1    1,   1    1    1,foo()
1416106614,9931,1416116545,3890956936,5307073481,102403095,3993369962,4157,4157,0,cudaLaunchKernel,  32    1    1,   1    1    1,foo()
1416116909,9995,1416126904,3993351176,5409478080,102403159,4095764330,4157,4157,0,cudaLaunchKernel,  32    1    1,   1    1    1,foo()
1416127277,9845,1416137122,4095745717,5511882839,102403064,4198158626,4157,4157,0,cudaLaunchKernel,  32    1    1,   1    1    1,foo()
1416137503,9972,1416147475,4198139963,5614287438,102403128,4300553063,4157,4157,0,cudaLaunchKernel,  32    1    1,   1    1    1,foo()
1416147845,9909,1416157754,4300534284,5716692038,102403191,4402947384,4157,4157,0,cudaLaunchKernel,  32    1    1,   1    1    1,foo()
1416158117,11774,1416169891,4402926810,5819096701,102403191,4505341775,4157,4157,0,cudaLaunchKernel,  32    1    1,   1    1    1,foo()
1416170303,9867,1416180170,4505321258,5921501428,102403128,4607734253,4157,4157,0,cudaLaunchKernel,  32    1    1,   1    1    1,foo()
1416180560,10063,1416190623,4607715340,6023905963,102403255,4710128658,4157,4157,0,cudaLaunchKernel,  32    1    1,   1    1    1,foo()
1416191010,9863,1416200873,4710109753,6126310626,102403255,4812522871,4157,4157,0,cudaLaunchKernel,  32    1    1,   1    1    1,foo()
1416201242,9950,1416211192,4812504161,6228715353,102403190,4914917301,4157,4157,0,cudaLaunchKernel,  32    1    1,   1    1    1,foo()
1416211588,9887,1416221475,4914898508,6331119983,102403222,5017311617,4157,4157,0,cudaLaunchKernel,  32    1    1,   1    1    1,foo()
1416221847,9925,1416231772,5017292841,6433524613,102403255,5119706021,4157,4157,0,cudaLaunchKernel,  32    1    1,   1    1    1,foo()
1416232145,10143,1416242288,5119687052,6535929340,102403190,5222100385,4157,4157,0,cudaLaunchKernel,  32    1    1,   1    1    1,foo()
1416242724,9848,1416252572,5222081335,6638333907,102403286,5324494469,4157,4157,0,cudaLaunchKernel,  32    1    1,   1    1    1,foo()
1416252953,9839,1416262792,5324475809,6740738601,102403254,5426888902,4157,4157,0,cudaLaunchKernel,  32    1    1,   1    1    1,foo()
1416263157,9921,1416273078,5426870313,6843143391,102403126,5529283360,4157,4157,0,cudaLaunchKernel,  32    1    1,   1    1    1,foo()
1416273452,12153,1416285605,5529262289,6945547894,102403286,5631677728,4157,4157,0,cudaLaunchKernel,  32    1    1,   1    1    1,foo()
1416286043,10202,1416296245,5631656343,7047952588,102403255,5734069800,4157,4157,0,cudaLaunchKernel,  32    1    1,   1    1    1,foo()
1416296633,9881,1416306514,5734050737,7150357251,102403254,5836463872,4157,4157,0,cudaLaunchKernel,  32    1    1,   1    1    1,foo()
1416306907,10088,1416316995,5836444950,7252761945,102403222,5938858260,4157,4157,0,cudaLaunchKernel,  32    1    1,   1    1    1,foo()
1416317357,9959,1416327316,5938839387,7355166703,102403127,6041252473,4157,4157,0,cudaLaunchKernel,  32    1    1,   1    1    1,foo()
1416327701,9993,1416337694,6041233608,7457571302,102403190,6143646791,4157,4157,0,cudaLaunchKernel,  32    1    1,   1    1    1,foo()
1416338084,10371,1416348455,6143627413,7559975868,102403287,6246041071,4157,4157,0,cudaLaunchKernel,  32    1    1,   1    1    1,foo()
1416348820,12376,1416361196,6246019431,7662380627,102403190,6348434997,4157,4157,0,cudaLaunchKernel,  32    1    1,   1    1    1,foo()
1416361622,9851,1416371473,6348413912,7764785385,102403094,6450826857,4157,4157,0,cudaLaunchKernel,  32    1    1,   1    1    1,foo()
1416371860,9985,1416381845,6450808010,7867189855,102403287,6553221282,4157,4157,0,cudaLaunchKernel,  32    1    1,   1    1    1,foo()
1416382209,9892,1416392101,6553202449,7969594550,102403254,6655615595,4157,4157,0,cudaLaunchKernel,  32    1    1,   1    1    1,foo()
1416392473,11803,1416404276,6655595032,8071999308,102403157,6758009992,4157,4157,0,cudaLaunchKernel,  32    1    1,   1    1    1,foo()
1416404677,9844,1416414521,6757989320,8174403841,102403285,6860402449,4157,4157,0,cudaLaunchKernel,  32    1    1,   1    1    1,foo()
1416414881,9915,1416424796,6860383705,8276808501,102403285,6962796905,4157,4157,0,cudaLaunchKernel,  32    1    1,   1    1    1,foo()
1416425157,9887,1416435044,6962778150,8379213194,102403252,7065191289,4157,4157,0,cudaLaunchKernel,  32    1    1,   1    1    1,foo()
1416435424,9906,1416445330,7065172621,8481617951,102403156,7167585683,4157,4157,0,cudaLaunchKernel,  32    1    1,   1    1    1,foo()
1416445710,9868,1416455578,7167567033,8584022611,102403157,7269980058,4157,4157,0,cudaLaunchKernel,  32    1    1,   1    1    1,foo()
1416455949,9960,1416465909,7269961363,8686427272,102403156,7372374479,4157,4157,0,cudaLaunchKernel,  32    1    1,   1    1    1,foo()
1416466279,10056,1416476335,7372355501,8788831836,102403253,7474768810,4157,4157,0,cudaLaunchKernel,  32    1    1,   1    1    1,foo()
1416476717,9940,1416486657,7474750000,8891236657,102403093,7577163033,4157,4157,0,cudaLaunchKernel,  32    1    1,   1    1    1,foo()
1416487056,13278,1416500334,7577140951,8993641285,102403125,7679557354,4157,4157,0,cudaLaunchKernel,  32    1    1,   1    1    1,foo()
1416500695,11962,1416512657,7679533225,9096045882,102403188,7781948375,4157,4157,0,cudaLaunchKernel,  32    1    1,   1    1    1,foo()
1416513041,9898,1416522939,7781927604,9198450543,102403188,7884340690,4157,4157,0,cudaLaunchKernel,  32    1    1,   1    1    1,foo()
1416523326,10090,1416533416,7884321915,9300855331,102403061,7986735066,4157,4157,0,cudaLaunchKernel,  32    1    1,   1    1    1,foo()
1416533791,12353,1416546144,7986713784,9403259928,102403124,8089129261,4157,4157,0,cudaLaunchKernel,  32    1    1,   1    1    1,foo()
1416546534,9810,1416556344,8089108084,9505664428,102403285,8191521179,4157,4157,0,cudaLaunchKernel,  32    1    1,   1    1    1,foo()
1416556711,9922,1416566633,8191502552,9608069185,102403188,8293915662,4157,4157,0,cudaLaunchKernel,  32    1    1,   1    1    1,foo()
1416567002,9912,1416576914,8293896963,9710473877,102403157,8396310032,4157,4157,0,cudaLaunchKernel,  32    1    1,   1    1    1,foo()
1416577285,9994,1416587279,8396291131,9812878410,102403284,8498704409,4157,4157,0,cudaLaunchKernel,  32    1    1,   1    1    1,foo()
1416587648,9935,1416597583,8498685616,9915283199,102403156,8601098707,4157,4157,0,cudaLaunchKernel,  32    1    1,   1    1    1,foo()
1416597947,9922,1416607869,8601079894,10017687763,102403253,8703493069,4157,4157,0,cudaLaunchKernel,  32    1    1,   1    1    1,foo()
1416608231,9964,1416618195,8703474421,10120092616,102403064,8805887449,4157,4157,0,cudaLaunchKernel,  32    1    1,   1    1    1,foo()
1416618573,11840,1416630413,8805866771,10222497184,102403160,8908281771,4157,4157,0,cudaLaunchKernel,  32    1    1,   1    1    1,foo()
1416630813,9868,1416640681,8908261167,10324901848,102403159,9010674194,4157,4157,0,cudaLaunchKernel,  32    1    1,   1    1    1,foo()
1416641055,25180,1416666235,9010640372,10427306607,102403064,9113068616,4157,4157,0,cudaLaunchKernel,  32    1    1,   1    1    1,foo()
1416666869,12643,1416679512,9113031695,10529711207,102403128,9215447466,4157,4157,0,cudaLaunchKernel,  32    1    1,   1    1    1,foo()
1416679928,9667,1416689595,9215426212,10632115807,102403191,9317839070,4157,4157,0,cudaLaunchKernel,  32    1    1,   1    1    1,foo()
1416690011,10114,1416700125,9317820378,10734520503,102403159,9420233651,4157,4157,0,cudaLaunchKernel,  32    1    1,   1    1    1,foo()
1416700495,9880,1416710375,9420214663,10836925038,102403288,9522627831,4157,4157,0,cudaLaunchKernel,  32    1    1,   1    1    1,foo()
1416710751,10264,1416721015,9522608719,10939329734,102403256,9625022239,4157,4157,0,cudaLaunchKernel,  32    1    1,   1    1    1,foo()
1416721409,9724,1416731133,9625003425,11041734558,102403095,9727416244,4157,4157,0,cudaLaunchKernel,  32    1    1,   1    1    1,foo()
1416731514,9956,1416741470,9727397559,11144139029,102403288,9829810803,4157,4157,0,cudaLaunchKernel,  32    1    1,   1    1    1,foo()
1416741839,9897,1416751736,9829791989,11246543725,102403256,9932205142,4157,4157,0,cudaLaunchKernel,  32    1    1,   1    1    1,foo()
1416752117,11652,1416763769,9932184780,11348948549,102403095,10034599527,4157,4157,0,cudaLaunchKernel,  32    1    1,   1    1    1,foo()
1416764195,9882,1416774077,10034579007,11451353084,102403224,10136992113,4157,4157,0,cudaLaunchKernel,  32    1    1,   1    1    1,foo()
1416774474,9880,1416784354,10136973458,11553757812,102403160,10239386498,4157,4157,0,cudaLaunchKernel,  32    1    1,   1    1    1,foo()
1416784738,9858,1416794596,10239367880,11656162476,102403160,10341780898,4157,4157,0,cudaLaunchKernel,  32    1    1,   1    1    1,foo()
1416794973,9890,1416804863,10341762180,11758567043,102403256,10444175326,4157,4157,0,cudaLaunchKernel,  32    1    1,   1    1    1,foo()
1416805225,9927,1416815152,10444156555,11860971707,102403256,10546569738,4157,4157,0,cudaLaunchKernel,  32    1    1,   1    1    1,foo()
1416815520,9944,1416825464,10546550875,11963376339,102403287,10648964106,4157,4157,0,cudaLaunchKernel,  32    1    1,   1    1    1,foo()
1416825846,9974,1416835820,10648945342,12065781162,102403129,10751358445,4157,4157,0,cudaLaunchKernel,  32    1    1,   1    1    1,foo()
1416836196,9927,1416846123,10751339576,12168185699,102403256,10853752759,4157,4157,0,cudaLaunchKernel,  32    1    1,   1    1    1,foo()
1416846495,10011,1416856506,10853733986,12270590492,102403128,10956147125,4157,4157,0,cudaLaunchKernel,  32    1    1,   1    1    1,foo()
1416856922,11859,1416868781,10956126343,12372995124,102403161,11058541363,4157,4157,0,cudaLaunchKernel,  32    1    1,   1    1    1,foo()
1416869168,9869,1416879037,11058520688,12475399725,102403225,11160933782,4157,4157,0,cudaLaunchKernel,  32    1    1,   1    1    1,foo()
1416879398,10218,1416889616,11160914902,12577804518,102403097,11263328217,4157,4157,0,cudaLaunchKernel,  32    1    1,   1    1    1,foo()
1416890008,10001,1416900009,11263309077,12680209086,102403193,11365722271,4157,4157,0,cudaLaunchKernel,  32    1    1,   1    1    1,foo()
1416900393,9904,1416910297,11365703358,12782613655,102403289,11468116551,4157,4157,0,cudaLaunchKernel,  32    1    1,   1    1    1,foo()
1416910655,9933,1416920588,11468097892,12885018480,102403128,11570510953,4157,4157,0,cudaLaunchKernel,  32    1    1,   1    1    1,foo()
1416920962,9978,1416930940,11570492205,12987423145,102403128,11672905311,4157,4157,0,cudaLaunchKernel,  32    1    1,   1    1    1,foo()
1416931319,10221,1416941540,11672886077,13089827617,102403321,11775299619,4157,4157,0,cudaLaunchKernel,  32    1    1,   1    1    1,foo()
1416941902,10188,1416952090,11775280320,13192232410,102403193,11877693701,4157,4157,0,cudaLaunchKernel,  32    1    1,   1    1    1,foo()
1416952452,9984,1416962436,11877674543,13294636979,102403289,11980087816,4157,4157,0,cudaLaunchKernel,  32    1    1,   1    1    1,foo()
1416962823,9913,1416972736,11980069067,13397041803,102403129,12082482109,4157,4157,0,cudaLaunchKernel,  32    1    1,   1    1    1,foo()
1416973112,12142,1416985254,12082461054,13499446308,102403289,12184876485,4157,4157,0,cudaLaunchKernel,  32    1    1,   1    1    1,foo()
1416985660,10297,1416995957,12184855048,13601851005,102403257,12287268602,4157,4157,0,cudaLaunchKernel,  32    1    1,   1    1    1,foo()
1416996321,9934,1417006255,12287249542,13704255797,102403129,12389662605,4157,4157,0,cudaLaunchKernel,  32    1    1,   1    1    1,foo()
1417006655,9891,1417016546,12389643916,13806660462,102403129,12492056936,4157,4157,0,cudaLaunchKernel,  32    1    1,   1    1    1,foo()
1417016933,9869,1417026802,12492038261,13909065063,102403193,12594451323,4157,4157,0,cudaLaunchKernel,  32    1    1,   1    1    1,foo()
1417027159,9970,1417037129,12594432599,14011469728,102403192,12696845761,4157,4157,0,cudaLaunchKernel,  32    1    1,   1    1    1,foo()
1417037497,9966,1417047463,12696827026,14113874489,102403094,12799240086,4157,4157,0,cudaLaunchKernel,  32    1    1,   1    1    1,foo()
1417047825,12393,1417060218,12799218869,14216279087,102403159,12901634421,4157,4157,0,cudaLaunchKernel,  32    1    1,   1    1    1,foo()
1417060662,10204,1417070866,12901612789,14318683655,102403254,13004026247,4157,4157,0,cudaLaunchKernel,  32    1    1,   1    1    1,foo()
1417071251,9800,1417081051,13004007427,14421088478,102403095,13106420322,4157,4157,0,cudaLaunchKernel,  32    1    1,   1    1    1,foo()
