API Start (ns),API Dur (ns),Queue Start (ns),Queue Dur (ns),Kernel Start (ns),Kernel Dur (ns),Total Dur (ns),PID,TID,DevId,API Function,GridXYZ,BlockXYZ,Kernel Name
289711718,1116853577,1406565295,1581,1406566876,102402070,1219257228,3161,3161,0,cudaLaunchKernel,  32    1    1,   1    1    1,foo()
1406568453,16844,1406585297,102385025,1508970322,102402325,204804194,3161,3161,0,cudaLaunchKernel,  32    1    1,   1    1    1,foo()
1406585972,11455,1406597427,204776404,1611373831,102402518,307190377,3161,3161,0,cudaLaunchKernel,  32    1    1,   1    1    1,foo()
1406597811,10379,1406608190,307169534,1713777724,102402326,409582239,3161,3161,0,cudaLaunchKernel,  32    1    1,   1    1    1,foo()
1406608564,11177,1406619741,409561685,1816181426,102402325,511975187,3161,3161,0,cudaLaunchKernel,  32    1    1,   1    1    1,foo()
1406620143,10296,1406630439,511954656,1918585095,102402357,614367309,3161,3161,0,cudaLaunchKernel,  32    1    1,   1    1    1,foo()
1406630805,11057,1406641862,614346935,2020988797,102402359,716760351,3161,3161,0,cudaLaunchKernel,  32    1    1,   1    1    1,foo()
1406642249,10063,1406652312,716740188,2123392500,102402360,819152611,3161,3161,0,cudaLaunchKernel,  32    1    1,   1    1    1,foo()
1406652738,10335,1406663073,819133195,2225796268,102402297,921545827,3161,3161,0,cudaLaunchKernel,  32    1    1,   1    1    1,foo()
1406663486,10104,1406673590,921526415,2328200005,102402264,1023938783,3161,3161,0,cudaLaunchKernel,  32    1    1,   1    1    1,foo()
1406673953,9993,1406683946,1023919763,2430603709,102402264,1126332020,3161,3161,0,cudaLaunchKernel,  32    1    1,   1    1    1,foo()
1406684313,13067,1406697380,1126310066,2533007446,102402232,1228725365,3161,3161,0,cudaLaunchKernel,  32    1    1,   1    1    1,foo()
1406697904,10605,1406708509,1228702641,2635411150,102402232,1331115478,3161,3161,0,cudaLaunchKernel,  32    1    1,   1    1    1,foo()
1406709023,10214,1406719237,1331095681,2737814918,102402168,1433508063,3161,3161,0,cudaLaunchKernel,  32    1    1,   1    1    1,foo()
1406719637,10303,1406729940,1433488618,2840218558,102402233,1535901154,3161,3161,0,cudaLaunchKernel,  32    1    1,   1    1    1,foo()
1406730372,9854,1406740226,1535882069,2942622295,102402200,1638294123,3161,3161,0,cudaLaunchKernel,  32    1    1,   1    1    1,foo()
1406740624,12956,1406753580,1638272451,3045026031,102402168,1740687575,3161,3161,0,cudaLaunchKernel,  32    1    1,   1    1    1,foo()
1406754004,10310,1406764314,1740665421,3147429735,102402169,1843077900,3161,3161,0,cudaLaunchKernel,  32    1    1,   1    1    1,foo()
1406764687,10041,1406774728,1843058680,3249833408,102402200,1945470921,3161,3161,0,cudaLaunchKernel,  32    1    1,   1    1    1,foo()
1406775104,9837,1406784941,1945452139,3352237080,102402232,2047864208,3161,3161,0,cudaLaunchKernel,  32    1    1,   1    1    1,foo()
1406785320,10001,1406795321,2047845368,3454640689,102402328,2150257697,3161,3161,0,cudaLaunchKernel,  32    1    1,   1    1    1,foo()
1406795727,9935,1406805662,2150238923,3557044585,102402136,2252650994,3161,3161,0,cudaLaunchKernel,  32    1    1,   1    1    1,foo()
1406806040,13276,1406819316,2252628973,3659448289,102402137,2355044386,3161,3161,0,cudaLaunchKernel,  32    1    1,   1    1    1,foo()
1406819738,9836,1406829574,2355022355,3761851929,102402201,2457434392,3161,3161,0,cudaLaunchKernel,  32    1    1,   1    1    1,foo()
1406829934,10125,1406840059,2457415479,3864255538,102402296,2559827900,3161,3161,0,cudaLaunchKernel,  32    1    1,   1    1    1,foo()
1406840455,9850,1406850305,2559809129,3966659434,102402104,2662221083,3161,3161,0,cudaLaunchKernel,  32    1    1,   1    1    1,foo()
1406850696,9878,1406860574,2662202500,4069063074,102402167,2764614545,3161,3161,0,cudaLaunchKernel,  32    1    1,   1    1    1,foo()
1406860931,10091,1406871022,2764595659,4171466681,102402262,2867008012,3161,3161,0,cudaLaunchKernel,  32    1    1,   1    1    1,foo()
1406871396,9814,1406881210,2866989301,4273870511,102402135,2969401250,3161,3161,0,cudaLaunchKernel,  32    1    1,   1    1    1,foo()
1406881602,10605,1406892207,2969381975,4376274182,102402166,3071794746,3161,3161,0,cudaLaunchKernel,  32    1    1,   1    1    1,foo()
1406892578,9885,1406902463,3071775421,4478677884,102402167,3174187473,3161,3161,0,cudaLaunchKernel,  32    1    1,   1    1    1,foo()
1406902814,9966,1406912780,3174168807,4581081587,102402166,3276580939,3161,3161,0,cudaLaunchKernel,  32    1    1,   1    1    1,foo()
1406913138,10008,1406923146,3276562015,4683485161,102402295,3378974318,3161,3161,0,cudaLaunchKernel,  32    1    1,   1    1    1,foo()
1406923546,11801,1406935347,3378953517,4785888864,102402295,3481367613,3161,3161,0,cudaLaunchKernel,  32    1    1,   1    1    1,foo()
1406935740,9865,1406945605,3481346929,4888292534,102402327,3583759121,3161,3161,0,cudaLaunchKernel,  32    1    1,   1    1    1,foo()
1406946000,9860,1406955860,3583740409,4990696269,102402294,3686152563,3161,3161,0,cudaLaunchKernel,  32    1    1,   1    1    1,foo()
1406956258,9939,1406966197,3686133935,5093100132,102402134,3788546008,3161,3161,0,cudaLaunchKernel,  32    1    1,   1    1    1,foo()
1406966566,10383,1406976949,3788526821,5195503770,102402198,3890939402,3161,3161,0,cudaLaunchKernel,  32    1    1,   1    1    1,foo()
1406977323,9850,1406987173,3890920268,5297907441,102402230,3993332348,3161,3161,0,cudaLaunchKernel,  32    1    1,   1    1    1,foo()
1406987563,9946,1406997509,3993313538,5400311047,102402327,4095725811,3161,3161,0,cudaLaunchKernel,  32    1    1,   1    1    1,foo()
1406997916,9904,1407007820,4095707122,5502714942,102402134,4198119160,3161,3161,0,cudaLaunchKernel,  32    1    1,   1    1    1,foo()
1407008179,9935,1407018114,4198100370,5605118484,102402294,4300512599,3161,3161,0,cudaLaunchKernel,  32    1    1,   1    1    1,foo()
1407018492,9975,1407028467,4300493784,5707522251,102402230,4402905989,3161,3161,0,cudaLaunchKernel,  32    1    1,   1    1    1,foo()
1407028825,11929,1407040754,4402885167,5809925921,102402263,4505299359,3161,3161,0,cudaLaunchKernel,  32    1    1,   1    1    1,foo()
1407041162,9963,1407051125,4505278467,5912329592,102402294,4607690724,3161,3161,0,cudaLaunchKernel,  32    1    1,   1    1    1,foo()
1407051484,9865,1407061349,4607672137,6014733486,102402103,4710084105,3161,3161,0,cudaLaunchKernel,  32    1    1,   1    1    1,foo()
1407061704,9892,1407071596,4710065369,6117136965,102402326,4812477587,3161,3161,0,cudaLaunchKernel,  32    1    1,   1    1    1,foo()
1407071950,10158,1407082108,4812458751,6219540859,102402134,4914871043,3161,3161,0,cudaLaunchKernel,  32    1    1,   1    1    1,foo()
1407082530,9878,1407092408,4914851962,6321944370,102402326,5017264166,3161,3161,0,cudaLaunchKernel,  32    1    1,   1    1    1,foo()
1407092784,9927,1407102711,5017245521,6424348232,102402167,5119657615,3161,3161,0,cudaLaunchKernel,  32    1    1,   1    1    1,foo()
1407103081,9926,1407113007,5119638800,6526751807,102402294,5222051020,3161,3161,0,cudaLaunchKernel,  32    1    1,   1    1    1,foo()
1407113422,9944,1407123366,5222032111,6629155477,102402327,5324444382,3161,3161,0,cudaLaunchKernel,  32    1    1,   1    1    1,foo()
1407123723,12060,1407135783,5324423525,6731559308,102402198,5426837783,3161,3161,0,cudaLaunchKernel,  32    1    1,   1    1    1,foo()
1407136271,9715,1407145986,5426816928,6833962914,102402295,5529228938,3161,3161,0,cudaLaunchKernel,  32    1    1,   1    1    1,foo()
1407146362,11866,1407158228,5529208485,6936366713,102402198,5631622549,3161,3161,0,cudaLaunchKernel,  32    1    1,   1    1    1,foo()
1407158649,9956,1407168605,5631601810,7038770415,102402199,5734013965,3161,3161,0,cudaLaunchKernel,  32    1    1,   1    1    1,foo()
1407168970,9885,1407178855,5733995295,7141174150,102402166,5836407346,3161,3161,0,cudaLaunchKernel,  32    1    1,   1    1    1,foo()
1407179214,9984,1407189198,5836388718,7243577916,102402103,5938800805,3161,3161,0,cudaLaunchKernel,  32    1    1,   1    1    1,foo()
1407189579,45680,1407235259,5938746200,7345981459,102402262,6041194142,3161,3161,0,cudaLaunchKernel,  32    1    1,   1    1    1,foo()
1407235865,12363,1407248228,6041136965,7448385193,102402231,6143551559,3161,3161,0,cudaLaunchKernel,  32    1    1,   1    1    1,foo()
1407248640,9996,1407258636,6143530292,7550788928,102402198,6245942486,3161,3161,0,cudaLaunchKernel,  32    1    1,   1    1    1,foo()
1407259021,10282,1407269303,6245923391,7653192694,102402135,6348335808,3161,3161,0,cudaLaunchKernel,  32    1    1,   1    1    1,foo()
1407269680,9964,1407279644,6348316689,7755596333,102402198,6450728851,3161,3161,0,cudaLaunchKernel,  32    1    1,   1    1    1,foo()
1407280032,9903,1407289935,6450709972,7857999907,102402327,6553122202,3161,3161,0,cudaLaunchKernel,  32    1    1,   1    1    1,foo()
1407290414,10511,1407300925,6553102813,7960403738,102402198,6655515522,3161,3161,0,cudaLaunchKernel,  32    1    1,   1    1    1,foo()
1407301325,12348,1407313673,6655493671,8062807344,102402296,6757908315,3161,3161,0,cudaLaunchKernel,  32    1    1,   1    1    1,foo()
1407314099,9966,1407324065,6757887080,8165211145,102402199,6860299245,3161,3161,0,cudaLaunchKernel,  32    1    1,   1    1    1,foo()
1407324451,9872,1407334323,6860280558,8267614881,102402168,6962692598,3161,3161,0,cudaLaunchKernel,  32    1    1,   1    1    1,foo()
1407334723,10041,1407344764,6962673725,8370018489,102402264,7065086030,3161,3161,0,cudaLaunchKernel,  32    1    1,   1    1    1,foo()
1407345138,11859,1407356997,7065065292,8472422289,102402169,7167479320,3161,3161,0,cudaLaunchKernel,  32    1    1,   1    1    1,foo()
1407357364,9856,1407367220,7167458646,8574825866,102402296,7269870798,3161,3161,0,cudaLaunchKernel,  32    1    1,   1    1    1,foo()
1407367591,9908,1407377499,7269852039,8677229538,102402328,7372264275,3161,3161,0,cudaLaunchKernel,  32    1    1,   1    1    1,foo()
1407377857,9925,1407387782,7372245684,8779633466,102402104,7474657713,3161,3161,0,cudaLaunchKernel,  32    1    1,   1    1    1,foo()
1407388139,10185,1407398324,7474638783,8882037107,102402168,7577051136,3161,3161,0,cudaLaunchKernel,  32    1    1,   1    1    1,foo()
1407398720,9894,1407408614,7577032069,8984440683,102402296,7679444259,3161,3161,0,cudaLaunchKernel,  32    1    1,   1    1    1,foo()
1407409012,11877,1407420889,7679423466,9086844355,102402328,7781837671,3161,3161,0,cudaLaunchKernel,  32    1    1,   1    1    1,foo()
1407421286,9939,1407431225,7781817026,9189248251,102402137,7884229102,3161,3161,0,cudaLaunchKernel,  32    1    1,   1    1    1,foo()
1407431623,10206,1407441829,7884210159,9291651988,102402104,7986622469,3161,3161,0,cudaLaunchKernel,  32    1    1,   1    1    1,foo()
1407442351,10667,1407453018,7986602578,9394055596,102402200,8089015445,3161,3161,0,cudaLaunchKernel,  32    1    1,   1    1    1,foo()
1407453371,10309,1407463680,8088995524,9496459204,102402296,8191408129,3161,3161,0,cudaLaunchKernel,  32    1    1,   1    1    1,foo()
1407464073,9735,1407473808,8191389100,9598862908,102402297,8293801132,3161,3161,0,cudaLaunchKernel,  32    1    1,   1    1    1,foo()
1407474171,10030,1407484201,8293782572,9701266773,102402136,8396194738,3161,3161,0,cudaLaunchKernel,  32    1    1,   1    1    1,foo()
1407484558,9920,1407494478,8396175775,9803670253,102402361,8498588056,3161,3161,0,cudaLaunchKernel,  32    1    1,   1    1    1,foo()
1407494831,10014,1407504845,8498569144,9906073989,102402329,8600981487,3161,3161,0,cudaLaunchKernel,  32    1    1,   1    1    1,foo()
1407505241,9862,1407515103,8600962751,10008477854,102402168,8703374781,3161,3161,0,cudaLaunchKernel,  32    1    1,   1    1    1,foo()
1407515459,9952,1407525411,8703356083,10110881494,102402232,8805768267,3161,3161,0,cudaLaunchKernel,  32    1    1,   1    1    1,foo()
1407525778,11849,1407537627,8805747539,10213285166,102402264,8908161652,3161,3161,0,cudaLaunchKernel,  32    1    1,   1    1    1,foo()
1407538051,9895,1407547946,8908140860,10315688806,102402328,9010553083,3161,3161,0,cudaLaunchKernel,  32    1    1,   1    1    1,foo()
1407548321,10008,1407558329,9010534341,10418092670,102402168,9112946517,3161,3161,0,cudaLaunchKernel,  32    1    1,   1    1    1,foo()
1407558694,10025,1407568719,9112927623,10520496342,102402200,9215339848,3161,3161,0,cudaLaunchKernel,  32    1    1,   1    1    1,foo()
1407569074,9901,1407578975,9215321040,10622900015,102402231,9317733172,3161,3161,0,cudaLaunchKernel,  32    1    1,   1    1    1,foo()
1407579329,10053,1407589382,9317714336,10725303718,102402232,9420126621,3161,3161,0,cudaLaunchKernel,  32    1    1,   1    1    1,foo()
1407589767,9823,1407599590,9420107865,10827707455,102402200,9522519888,3161,3161,0,cudaLaunchKernel,  32    1    1,   1    1    1,foo()
1407599947,10574,1407610521,9522500542,10930111063,102402296,9624913412,3161,3161,0,cudaLaunchKernel,  32    1    1,   1    1    1,foo()
1407611039,10139,1407621178,9624893557,11032514735,102402328,9727306024,3161,3161,0,cudaLaunchKernel,  32    1    1,   1    1    1,foo()
1407621538,10028,1407631566,9727287001,11134918567,102402200,9829699229,3161,3161,0,cudaLaunchKernel,  32    1    1,   1    1    1,foo()
1407631935,9672,1407641607,9829680632,11237322239,102402232,9932092536,3161,3161,0,cudaLaunchKernel,  32    1    1,   1    1    1,foo()
1407642027,11596,1407653623,9932072352,11339725975,102402200,10034486148,3161,3161,0,cudaLaunchKernel,  32    1    1,   1    1    1,foo()
1407654066,9921,1407663987,10034465692,11442129679,102402200,10136877813,3161,3161,0,cudaLaunchKernel,  32    1    1,   1    1    1,foo()
1407664376,9928,1407674304,10136858951,11544533255,102402328,10239271207,3161,3161,0,cudaLaunchKernel,  32    1    1,   1    1    1,foo()
1407674699,9861,1407684560,10239252591,11646937151,102402136,10341664588,3161,3161,0,cudaLaunchKernel,  32    1    1,   1    1    1,foo()
1407684917,10190,1407695107,10341645620,11749340727,102402264,10444058074,3161,3161,0,cudaLaunchKernel,  32    1    1,   1    1    1,foo()
1407695465,9938,1407705403,10444039156,11851744559,102402136,10546451230,3161,3161,0,cudaLaunchKernel,  32    1    1,   1    1    1,foo()
1407705760,10000,1407715760,10546432343,11954148103,102402296,10648844639,3161,3161,0,cudaLaunchKernel,  32    1    1,   1    1    1,foo()
1407716120,9868,1407725988,10648826011,12056551999,102402104,10751237983,3161,3161,0,cudaLaunchKernel,  32    1    1,   1    1    1,foo()
1407726344,10020,1407736364,10751219147,12158955511,102402296,10853631463,3161,3161,0,cudaLaunchKernel,  32    1    1,   1    1    1,foo()
1407736720,10013,1407746733,10853612610,12261359343,102402167,10956024790,3161,3161,0,cudaLaunchKernel,  32    1    1,   1    1    1,foo()
1407747098,12228,1407759326,10956003528,12363762854,102402359,11058418115,3161,3161,0,cudaLaunchKernel,  32    1    1,   1    1    1,foo()
1407759755,9815,1407769570,11058397148,12466166718,102402199,11160809162,3161,3161,0,cudaLaunchKernel,  32    1    1,   1    1    1,foo()
1407769937,9935,1407779872,11160790645,12568570517,102402104,11263202684,3161,3161,0,cudaLaunchKernel,  32    1    1,   1    1    1,foo()
1407780272,10207,1407790479,11263183518,12670973997,102402327,11365596052,3161,3161,0,cudaLaunchKernel,  32    1    1,   1    1    1,foo()
1407790866,10722,1407801588,11365576112,12773377700,102402328,11467989162,3161,3161,0,cudaLaunchKernel,  32    1    1,   1    1    1,foo()
1407801947,10211,1407812158,11467969374,12875781532,102402199,11570381784,3161,3161,0,cudaLaunchKernel,  32    1    1,   1    1    1,foo()
1407812531,10028,1407822559,11570362580,12978185139,102402296,11672774904,3161,3161,0,cudaLaunchKernel,  32    1    1,   1    1    1,foo()
1407822922,10088,1407833010,11672755801,13080588811,102402327,11775168216,3161,3161,0,cudaLaunchKernel,  32    1    1,   1    1    1,foo()
1407833368,9981,1407843349,11775149293,13182992642,102402200,11877561474,3161,3161,0,cudaLaunchKernel,  32    1    1,   1    1    1,foo()
1407843738,9929,1407853667,11877542615,13285396282,102402263,11979954807,3161,3161,0,cudaLaunchKernel,  32    1    1,   1    1    1,foo()
1407854065,10451,1407864516,11979935565,13387800081,102402168,12082348184,3161,3161,0,cudaLaunchKernel,  32    1    1,   1    1    1,foo()
1407864910,11830,1407876740,12082326885,13490203625,102402327,12184741042,3161,3161,0,cudaLaunchKernel,  32    1    1,   1    1    1,foo()
1407877115,10378,1407887493,12184719995,13592607488,102402168,12287132541,3161,3161,0,cudaLaunchKernel,  32    1    1,   1    1    1,foo()
1407887854,9923,1407897777,12287113447,13695011224,102402135,12389525505,3161,3161,0,cudaLaunchKernel,  32    1    1,   1    1    1,foo()
1407898156,9806,1407907962,12389506997,13797414959,102402104,12491918907,3161,3161,0,cudaLaunchKernel,  32    1    1,   1    1    1,foo()
1407908383,9921,1407918304,12491900263,13899818567,102402199,12594312383,3161,3161,0,cudaLaunchKernel,  32    1    1,   1    1    1,foo()
1407918661,10087,1407928748,12594293362,14002222110,102402360,12696705809,3161,3161,0,cudaLaunchKernel,  32    1    1,   1    1    1,foo()
1407929103,10108,1407939211,12696686763,14104625974,102402200,12799099071,3161,3161,0,cudaLaunchKernel,  32    1    1,   1    1    1,foo()
1407939583,12806,1407952389,12799077193,14207029582,102402296,12901492295,3161,3161,0,cudaLaunchKernel,  32    1    1,   1    1    1,foo()
1407952812,10328,1407963140,12901470115,14309433255,102402328,13003882771,3161,3161,0,cudaLaunchKernel,  32    1    1,   1    1    1,foo()
1407963594,10292,1407973886,13003863233,14411837119,102402168,13106275693,3161,3161,0,cudaLaunchKernel,  32    1    1,   1    1    1,foo()
